丁	丁
丂	丂
七	七
丄	丄
丅	丅
万	万
丈	丈
三	三
上	上
下	下
丌	丌
不	不
丐	丐
丑	丑
丒	丒
且	且
丕	丕
世	世
丗	丗
丘	丘
丙	丙
丞	丞
丟	丢
丠	丠
両	両
並	并
丫	丫
丬	丬
中	中
丮	丮
丯	丯
丰	丰
串	串
丳	丳
丵	丵
丷	丷
丸	丸
丹	丹
主	主
丼	丼
乂	乂
乃	乃
久	久
乆	乆
乇	乇
么	幺
乍	乍
乎	乎
乏	乏
乑	乑
乒	乒
乓	乓
乕	乕
乖	乖
乗	乘
乘	乘
乜	乜
九	九
乞	乞
也	也
乢	乢
乣	乣
乨	乨
乩	乩
乪	乪
乫	乫
乭	乭
乳	乳
乴	乴
乵	乵
乶	乶
乷	乷
乸	乸
乹	乹
乾	干
乿	乿
亀	亀
亁	亁
亂	乱
亃	亃
亄	亄
了	了
予	予
亊	亊
事	事
二	二
亍	亍
于	于
亐	亐
云	云
互	互
亓	亓
五	五
井	井
亖	亖
亗	亗
亙	亘
些	些
亜	亚
亝	亝
亞	亚
亟	亟
亠	亠
亡	亡
亢	亢
亣	亣
交	交
亥	亥
亦	亦
亨	亨
享	享
京	京
亭	亭
亮	亮
亯	亯
亰	亰
亱	亱
亳	亳
亴	亴
亶	亶
亷	亷
亹	亹
人	人
亻	亻
亼	亼
亾	亾
什	什
仁	仁
仂	仂
仃	仃
仄	仄
仆	仆
仇	仇
仈	仈
仉	仉
今	今
介	介
仌	仌
仍	仍
仏	仏
仐	仐
仒	仒
仔	仔
仕	仕
他	他
仗	仗
付	付
仙	仙
仚	仚
仛	仛
仜	仜
仝	同
仞	仞
仟	仟
仠	仠
仡	仡
仢	仢
代	代
令	令
以	以
仦	仦
仧	仧
仨	仨
仫	仫
仭	仭
仮	仮
仯	仯
仰	仰
仱	仱
仲	仲
仳	仳
仴	仴
仵	仵
件	件
仸	仸
仹	仹
仺	仺
任	任
仼	仼
份	份
仾	仾
仿	仿
伀	伀
企	企
伂	伂
伃	伃
伄	伄
伅	伅
伆	伆
伇	伇
伈	伈
伉	伉
伊	伊
伋	伋
伌	伌
伍	伍
伎	伎
伏	伏
伐	伐
休	休
伒	伒
伓	伓
伔	伔
伕	伕
伖	伖
伙	伙
伜	伜
伢	伢
伨	伨
伩	伩
伭	伭
伮	伮
伯	伯
估	估
伱	伱
伲	伲
伳	伳
伴	伴
伵	伵
伶	伶
伷	伷
伸	伸
伹	伹
伺	伺
伻	伻
似	似
伽	伽
伾	伾
伿	伿
佀	佀
佁	佁
佂	佂
佃	佃
佄	佄
佅	佅
但	但
佇	伫
佈	布
佉	佉
佊	佊
佋	佋
佌	佌
位	位
低	低
住	住
佐	佐
佑	佑
佒	佒
佔	佔
何	何
佖	佖
佗	佗
佘	佘
余	余
佚	佚
佛	佛
作	作
佝	佝
佞	佞
佟	佟
你	你
佡	佡
佢	佢
佣	佣
佤	佤
佧	佧
佩	佩
佪	佪
佫	佫
佬	佬
佭	佭
佮	佮
佯	佯
佰	佰
佱	佱
佲	佲
佳	佳
佴	佴
併	并
佶	佶
佷	佷
佸	佸
佹	佹
佺	佺
佻	佻
佼	佼
佽	佽
佾	佾
使	使
侀	侀
侁	侁
侂	侂
侃	侃
侄	侄
侅	侅
來	来
侇	侇
侈	侈
侉	侉
侊	侊
例	例
侌	侌
侍	侍
侎	侎
侏	侏
侐	侐
侑	侑
侒	侒
侓	侓
侔	侔
侕	侕
侖	仑
侗	侗
侘	侘
侙	侙
侚	侚
供	供
侜	侜
依	依
侞	侞
侟	侟
価	价
侢	侢
侫	侫
侭	侭
侮	侮
侯	侯
侰	侰
侱	侱
侲	侲
侳	侳
侴	侴
侵	侵
侶	侣
侷	侷
侸	侸
侹	侹
侺	侺
侻	侻
侼	侼
侽	侽
侾	侾
便	便
俀	俀
俁	俣
係	系
促	促
俄	俄
俅	俅
俆	俆
俇	俇
俈	俈
俉	俉
俊	俊
俋	俋
俌	俌
俍	俍
俎	俎
俏	俏
俐	俐
俑	俑
俒	俒
俓	□
俔	伣
俕	俕
俖	俖
俗	俗
俘	俘
俙	俙
俚	俚
俛	俛
俜	俜
保	保
俞	俞
俟	俟
俠	侠
信	信
俢	俢
俤	俤
俥	伡
修	修
俯	俯
俰	俰
俱	俱
俲	俲
俳	俳
俴	□
俵	俵
俶	俶
俷	俷
俸	俸
俹	□
俺	俺
俻	俻
俼	俼
俽	俽
俾	俾
俿	俿
倀	伥
倁	倁
倂	併
倃	倃
倄	倄
倅	倅
倆	俩
倇	倇
倈	俫
倉	仓
倊	倊
個	个
倌	倌
倍	倍
倎	倎
倏	倏
倐	倐
們	们
倒	倒
倓	倓
倔	倔
倕	倕
倖	幸
倗	倗
倘	倘
候	候
倚	倚
倛	倛
倜	倜
倝	倝
倞	倞
借	借
倠	倠
倡	倡
倢	倢
倣	倣
値	値
倥	倥
倦	倦
倧	倧
倨	倨
倩	倩
倪	倪
倫	伦
倬	倬
倭	倭
倮	倮
倯	倯
倰	倰
倱	倱
倲	□
倳	倳
倴	倴
倵	倵
倶	倶
倷	倷
倸	倸
倹	俭
倻	倻
值	值
倽	倽
偀	偀
偁	偁
偂	偂
偃	偃
偄	偄
偅	偅
偆	偆
假	假
偈	偈
偉	伟
偊	偊
偋	偋
偌	偌
偍	偍
偎	偎
偏	偏
偐	偐
偑	□
偒	偒
偓	偓
偔	偔
偕	偕
偖	偖
偗	偗
偘	偘
偙	偙
做	做
偛	偛
停	停
偝	偝
偞	偞
偟	偟
偠	偠
偡	偡
偢	偢
偣	偣
偤	偤
健	健
偦	偦
偧	偧
偨	偨
偩	□
偪	偪
偫	偫
偬	偬
偭	偭
偮	偮
偯	偯
偰	偰
偱	偱
偲	偲
偳	偳
側	侧
偵	侦
偶	偶
偷	偷
偸	偷
偹	偹
偺	偺
偼	偼
偽	伪
傀	傀
傁	傁
傂	傂
傃	傃
傄	傄
傅	傅
傆	傆
傇	傇
傈	傈
傉	傉
傊	□
傋	傋
傌	傌
傍	傍
傎	傎
傏	傏
傐	傐
傑	杰
傒	傒
傓	傓
傔	傔
傕	傕
傖	伧
傗	傗
傘	伞
備	备
傚	傚
傛	傛
傜	□
傝	傝
傞	傞
傟	傟
傠	□
傡	傡
傢	家
傣	傣
傪	□
傫	傫
催	催
傭	佣
傮	傮
傯	傯
傰	傰
傱	□
傲	傲
傳	传
傴	伛
債	债
傶	傶
傷	伤
傸	傸
傹	傹
傺	傺
傻	傻
傼	傼
傽	傽
傾	倾
傿	傿
僀	□
僁	僁
僂	偻
僃	僃
僄	僄
僅	仅
僆	□
僇	僇
僈	僈
僉	佥
僊	僊
僋	□
僌	僌
働	□
僎	僎
像	像
僐	僐
僑	侨
僒	僒
僓	□
僔	僔
僕	仆
僖	僖
僗	□
僘	僘
僙	僙
僚	僚
僛	僛
僜	僜
僝	僝
僞	伪
僟	□
僠	僠
僡	僡
僢	僢
僣	僣
僤	□
僥	侥
僦	僦
僧	僧
僨	偾
僩	□
僪	僪
僫	□
僬	僬
僭	僭
僮	僮
僯	僯
僰	僰
僱	雇
僳	僳
僴	□
僵	僵
僶	□
僷	僷
僸	僸
價	价
僺	僺
僻	僻
僼	僼
僽	僽
僾	□
僿	僿
儀	仪
儁	儁
儂	侬
儃	儃
億	亿
儅	□
儆	儆
儇	儇
儈	侩
儉	俭
儊	儊
儋	儋
儌	儌
儍	傻
儎	傤
儐	傧
儑	□
儒	儒
儓	□
儔	俦
儕	侪
儖	□
儗	儗
儘	尽
儙	儙
儚	□
儛	儛
儜	□
儝	□
儞	□
償	偿
儠	儠
儡	儡
儢	□
儣	□
儤	儤
儥	□
儦	儦
儧	□
儨	□
儩	□
優	优
儫	儫
儬	□
儭	□
儮	□
儯	□
儰	□
儱	□
儲	储
儳	儳
儴	儴
儵	儵
儶	儶
儷	俪
儸	□
儹	□
儺	傩
儻	傥
儼	俨
儽	儽
儾	儾
兀	兀
允	允
兂	兂
元	元
兄	兄
充	充
兆	兆
兇	凶
先	先
光	光
兊	兑
克	克
兌	兑
免	免
兎	兔
兏	兏
児	児
兒	儿
兓	兓
兔	兔
兕	兕
兖	兖
兗	兗
兘	兘
兛	兛
兜	兜
兝	兝
兞	兞
兟	兟
兠	兠
兢	兢
兣	兣
兤	□
入	入
兦	兦
內	内
全	全
兩	两
兪	俞
八	八
公	公
六	六
兮	兮
共	共
兲	兲
兵	兵
其	其
具	具
典	典
兼	兼
兾	兾
兿	艺
冀	冀
冂	冂
冄	冄
円	圆
冇	冇
冉	冉
冊	册
冋	冋
再	再
冏	冏
冐	冐
冑	冑
冒	冒
冓	冓
冔	冔
冕	冕
冖	冖
冗	冗
冘	冘
冚	冚
冝	冝
冞	冞
冟	冟
冠	冠
冡	冡
冢	冢
冣	冣
冤	冤
冥	冥
冦	冦
冧	冧
冨	冨
冩	冩
冪	幂
冫	冫
冬	冬
冭	冭
冮	冮
冰	冰
冱	冱
冴	冴
冶	冶
冷	冷
冸	冸
冹	冹
冺	冺
冼	冼
冽	冽
冾	冾
冿	冿
凁	凁
凂	凂
凃	凃
凅	凅
准	准
凇	凇
凈	净
凊	凊
凋	凋
凌	凌
凍	冻
凎	凎
凐	凐
凒	□
凓	凓
凔	□
凕	凕
凗	凗
凘	凘
凙	□
凚	凚
凜	凛
凝	凝
凞	凞
凟	□
几	几
凡	凡
凢	凢
凣	凣
凥	凥
処	处
凧	凧
凨	凨
凬	凬
凮	凮
凰	凰
凱	凯
凲	凲
凳	凳
凴	□
凵	凵
凶	凶
凷	凷
出	出
凼	凼
函	函
凾	凾
刀	刀
刂	刂
刃	刃
刄	刄
刅	刅
分	分
切	切
刈	刈
刉	刉
刊	刊
刋	刋
刌	刌
刍	刍
刎	刎
刏	刏
刐	刐
刑	刑
划	划
刓	刓
刔	刔
刕	刕
刖	刖
列	列
刜	刜
初	初
刞	刞
刟	刟
刡	刡
刢	刢
刣	刣
判	判
別	别
刦	劫
刧	劫
刨	刨
利	利
刪	删
刮	刮
刯	刯
到	到
刱	刱
刲	刲
刳	刳
刴	剁
刵	刵
制	制
刷	刷
券	券
刺	刺
刻	刻
刼	劫
剁	剁
剃	剃
剄	刭
剅	剅
剆	剆
則	则
剈	剈
剉	剉
削	削
剋	克
剌	剌
前	前
剎	刹
剏	剏
剒	剒
剓	剓
剔	剔
剕	剕
剖	剖
剗	刬
剘	剘
剙	剙
剚	剚
剛	刚
剜	剜
剝	剥
剞	剞
剟	剟
剠	剠
剡	剡
剢	剢
剣	剑
剤	剂
剦	剦
剨	剨
剩	剩
剪	剪
剫	剫
剬	剬
剭	剭
剮	剐
副	副
剰	剩
剱	剑
割	割
剳	剳
剴	剀
創	创
剶	剶
剸	□
剹	剹
剺	剺
剻	剻
剼	□
剽	剽
剾	□
剿	剿
劀	劀
劁	劁
劂	劂
劃	划
劄	劄
劅	劅
劆	劆
劇	剧
劈	劈
劉	刘
劊	刽
劋	劋
劌	刿
劍	剑
劎	剑
劏	□
劐	劐
劑	剂
劒	剑
劓	劓
劔	剑
劕	□
劖	劖
劗	□
劘	劘
劙	劙
劚	□
力	力
劜	劜
功	功
加	加
劣	劣
劤	劤
劥	劥
劦	劦
劧	劧
助	助
努	努
劫	劫
劬	劬
劭	劭
劮	劮
劯	劯
劰	劰
労	劳
劵	劵
劶	劶
劷	劷
劸	劸
効	効
劺	劺
劻	劻
劼	劼
劽	劽
劾	劾
勀	勀
勁	劲
勂	勂
勃	勃
勄	勄
勅	勅
勆	勆
勇	勇
勈	勈
勉	勉
勊	勊
勌	勌
勍	勍
勎	勎
勏	勏
勐	勐
勑	□
勒	勒
勓	勓
勔	勔
動	动
勖	勖
勗	勗
勘	勘
務	务
勛	勋
勜	勜
勝	胜
勞	劳
募	募
勠	勠
勡	勡
勢	势
勣	□
勤	勤
勥	勥
勦	勦
勧	劝
勨	勨
勩	勚
勪	□
勫	勫
勬	勬
勭	勭
勮	勮
勯	勯
勰	勰
勱	劢
勲	勲
勳	勳
勴	□
勵	励
勶	勶
勷	勷
勸	劝
勹	勹
勺	勺
勻	匀
勼	勼
勽	勽
勾	勾
勿	勿
匃	匃
匄	匄
包	包
匆	匆
匈	匈
匉	匉
匊	匊
匋	匋
匌	匌
匍	匍
匎	匎
匏	匏
匐	匐
匑	匑
匒	匒
匓	匓
匔	匔
匕	匕
化	化
北	北
匘	□
匙	匙
匛	匛
匜	匜
匝	匝
匞	匞
匟	匟
匠	匠
匡	匡
匢	匢
匣	匣
匤	匤
匥	匥
匧	匧
匨	□
匩	匩
匪	匪
匫	匫
匬	匬
匭	匦
匯	汇
匰	□
匱	匮
匲	匲
匳	□
匴	匴
匵	□
匶	□
匷	匷
匹	匹
匼	匼
匽	匽
匾	匾
匿	匿
區	区
十	十
卂	卂
千	千
卄	卄
卅	卅
卆	卆
升	升
午	午
卉	卉
半	半
卋	卋
卌	卌
卑	卑
卒	卒
卓	卓
協	协
南	南
単	単
卙	卙
博	博
卛	□
卜	卜
卝	卝
卞	卞
卟	卟
占	占
卡	卡
卣	卣
卥	卥
卦	卦
卨	□
卩	卩
卪	卪
卬	卬
卭	卭
卮	卮
卯	卯
印	印
危	危
卲	卲
即	即
卵	卵
卶	卶
卷	卷
卸	卸
卹	卹
卺	卺
卻	却
卼	卼
卽	即
卾	卾
卿	卿
厀	厀
厃	厃
厄	厄
厇	厇
厈	厈
厊	厊
厎	厎
厏	厏
厒	厒
厓	厓
厔	厔
厖	厖
厗	厗
厙	厍
厚	厚
厛	厅
厜	厜
厝	厝
厞	厞
原	原
厡	厡
厤	厤
厥	厥
厧	厧
厪	厪
厫	厫
厬	厬
厭	厌
厯	厯
厰	厰
厱	□
厲	厉
厳	严
厴	厣
厵	厵
厶	厶
厷	厷
厸	厸
厹	厹
厺	厺
去	去
厽	厽
厾	厾
叀	叀
參	参
叄	叁
叅	叅
叉	叉
及	及
友	友
反	反
収	収
叏	叏
叐	叐
叒	叒
叓	叓
叔	叔
叕	叕
取	取
受	受
叚	叚
叛	叛
叜	叜
叝	叝
叞	叞
叟	叟
叡	叡
叢	丛
口	口
古	古
句	句
另	另
叧	叧
叨	叨
叩	叩
只	只
叫	叫
召	召
叭	叭
叮	叮
可	可
台	台
叱	叱
史	史
右	右
叴	叴
叵	叵
司	司
叺	叺
叻	叻
叼	叼
叿	叿
吀	吀
吁	吁
吂	吂
吃	吃
各	各
吅	吅
吆	吆
吇	吇
合	合
吉	吉
吋	吋
同	同
名	名
后	后
吏	吏
吐	吐
向	向
吒	咤
吓	吓
吔	吔
吖	吖
吘	吘
吙	吙
吚	吚
君	君
吜	吜
吝	吝
吞	吞
吟	吟
吠	吠
吡	吡
吢	吢
吣	吣
吤	吤
吥	吥
否	否
吧	吧
吩	吩
吪	吪
含	含
吭	吭
吮	吮
吰	吰
吱	吱
吲	吲
吳	吴
吵	吵
吶	呐
吷	吷
吸	吸
吹	吹
吺	吺
吻	吻
吼	吼
吽	吽
吾	吾
吿	吿
呀	呀
呁	呁
呂	吕
呃	呃
呄	呄
呅	呅
呆	呆
呇	呇
呈	呈
呉	吴
告	告
呋	呋
呌	呌
呍	呍
呎	呎
呏	呏
呑	吞
呔	呔
呝	呝
呞	呞
呟	呟
呠	呠
呡	呡
呢	呢
呤	呤
呥	呥
呦	呦
呧	呧
周	周
呩	呩
呪	呪
呫	呫
呬	呬
呭	呭
呮	呮
呯	呯
呰	呰
呱	呱
呲	呲
味	味
呴	呴
呵	呵
呶	呶
呷	呷
呸	呸
呹	呹
呺	呺
呻	呻
呼	呼
命	命
呾	呾
呿	呿
咀	咀
咂	咂
咃	咃
咄	咄
咅	咅
咆	咆
咇	咇
咈	咈
咉	咉
咊	咊
咋	咋
和	和
咍	咍
咎	咎
咐	咐
咑	咑
咒	咒
咓	咓
咔	咔
咕	咕
咖	咖
咗	咗
咘	咘
咚	咚
咞	咞
咟	咟
咠	咠
咡	咡
咢	咢
咣	咣
咤	咤
咥	咥
咦	咦
咧	咧
咨	咨
咩	咩
咪	咪
咫	咫
咬	咬
咭	咭
咮	咮
咯	咯
咰	咰
咱	咱
咲	咲
咳	咳
咴	咴
咵	咵
咶	咶
咷	咷
咸	咸
咹	咹
咺	咺
咻	咻
咼	呙
咽	咽
咾	咾
咿	咿
哀	哀
品	品
哂	哂
哃	哃
哄	哄
哅	哅
哆	哆
哇	哇
哈	哈
哉	哉
哊	哊
哋	哋
哌	哌
响	响
哎	哎
哏	哏
哐	哐
哚	哚
哞	哞
哠	哠
員	员
哢	哢
哣	哣
哤	哤
哥	哥
哦	哦
哧	哧
哨	哨
哩	哩
哪	哪
哫	哫
哬	哬
哭	哭
哮	哮
哯	□
哰	哰
哱	哱
哲	哲
哳	哳
哴	哴
哵	哵
哶	哶
哷	哷
哸	哸
哹	哹
哺	哺
哻	哻
哼	哼
哽	哽
哾	哾
哿	哿
唀	唀
唁	唁
唂	唂
唃	唃
唄	呗
唅	唅
唆	唆
唇	唇
唈	唈
唉	唉
唊	□
唋	唋
唌	唌
唍	唍
唎	唎
唏	唏
唐	唐
唑	唑
唒	唒
唓	□
唔	唔
唕	唕
唖	哑
唗	唗
唘	唘
唙	唙
唚	唚
唞	唞
唣	唣
唥	唥
唦	唦
唧	唧
唨	唨
唩	唩
唪	唪
唫	唫
唬	唬
唭	唭
售	售
唯	唯
唰	唰
唱	唱
唲	唲
唳	唳
唴	唴
唵	唵
唶	唶
唷	唷
唸	念
唹	唹
唺	唺
唻	□
唼	唼
唽	唽
唾	唾
唿	唿
啀	啀
啁	啁
啂	啂
啃	啃
啄	啄
啅	啅
商	商
啇	啇
啈	啈
啉	啉
啊	啊
啋	啋
啌	啌
啍	啍
啎	啎
問	问
啐	啐
啑	啑
啒	啒
啓	启
啔	啔
啕	啕
啖	啖
啗	啗
啘	啘
啙	啙
啚	啚
啛	啛
啜	啜
啝	啝
啞	哑
啟	启
啠	啠
啡	啡
啢	唡
啣	啣
啤	啤
啥	啥
啦	啦
啨	啨
啩	啩
啪	啪
啫	啫
啱	啱
啲	啲
啳	啳
啵	啵
啶	啶
啷	啷
啺	□
啻	啻
啼	啼
啽	啽
啾	啾
啿	啿
喀	喀
喁	喁
喂	喂
喃	喃
善	善
喅	喅
喆	哲
喇	喇
喈	喈
喉	喉
喊	喊
喋	喋
喌	喌
喍	喍
喎	㖞
喏	喏
喐	喐
喑	喑
喒	喒
喓	喓
喔	喔
喕	喕
喖	喖
喗	□
喘	喘
喙	喙
喚	唤
喛	喛
喜	喜
喝	喝
喞	唧
喟	喟
喠	喠
喡	□
喢	喢
喣	喣
喤	喤
喥	喥
喦	喦
喧	喧
喨	喨
喩	喩
喪	丧
喫	喫
喬	乔
喭	喭
單	单
喯	喯
喰	喰
喱	喱
喲	哟
喳	喳
喴	喴
喵	喵
営	营
喹	喹
喺	□
喻	喻
喼	喼
喿	喿
嗀	嗀
嗁	嗁
嗂	□
嗃	嗃
嗄	嗄
嗅	嗅
嗆	呛
嗇	啬
嗈	嗈
嗉	嗉
嗊	唝
嗋	嗋
嗌	嗌
嗍	嗍
嗎	吗
嗏	嗏
嗐	嗐
嗑	嗑
嗒	嗒
嗓	嗓
嗔	嗔
嗕	嗕
嗖	嗖
嗗	嗗
嗘	嗘
嗙	嗙
嗚	呜
嗛	嗛
嗜	嗜
嗝	嗝
嗞	嗞
嗟	嗟
嗠	嗠
嗡	嗡
嗢	嗢
嗣	嗣
嗤	嗤
嗥	嗥
嗦	嗦
嗨	嗨
嗩	唢
嗪	嗪
嗬	嗬
嗮	嗮
嗯	嗯
嗰	□
嗱	嗱
嗲	嗲
嗵	嗵
嗶	哔
嗷	嗷
嗸	嗸
嗹	□
嗺	嗺
嗻	嗻
嗼	嗼
嗽	嗽
嗾	嗾
嗿	□
嘀	嘀
嘁	嘁
嘂	嘂
嘃	嘃
嘄	□
嘅	嘅
嘆	叹
嘇	□
嘈	嘈
嘉	嘉
嘊	嘊
嘋	嘋
嘌	嘌
嘍	喽
嘎	嘎
嘏	嘏
嘐	嘐
嘑	嘑
嘒	嘒
嘓	啯
嘔	呕
嘕	嘕
嘖	啧
嘗	尝
嘙	嘙
嘚	嘚
嘛	嘛
嘜	唛
嘝	嘝
嘞	嘞
嘟	嘟
嘠	嘠
嘡	嘡
嘢	嘢
嘣	嘣
嘥	嘥
嘦	嘦
嘧	嘧
嘨	啸
嘩	哗
嘪	□
嘫	嘫
嘬	嘬
嘭	嘭
嘮	唠
嘯	啸
嘰	叽
嘲	嘲
嘳	□
嘴	嘴
嘵	哓
嘶	嘶
嘷	嘷
嘸	呒
嘹	嘹
嘺	□
嘻	嘻
嘼	嘼
嘽	啴
嘾	嘾
嘿	嘿
噀	噀
噁	恶
噂	噂
噃	噃
噄	噄
噅	□
噆	噆
噇	噇
噈	噈
噉	噉
噊	噊
噋	噋
噌	噌
噍	噍
噎	噎
噏	噏
噐	噐
噑	噑
噒	噒
噓	嘘
噔	噔
噕	□
噖	噖
噗	噗
噘	噘
噙	噙
噚	□
噛	啮
噝	咝
噞	□
噟	噟
噠	哒
噡	噡
噢	噢
噣	噣
噤	噤
噥	哝
噦	哕
噧	□
器	器
噩	噩
噪	噪
噫	噫
噬	噬
噭	噭
噮	噮
噯	嗳
噰	噰
噱	噱
噲	哙
噳	噳
噴	喷
噵	噵
噶	噶
噷	噷
噸	吨
噹	当
噻	噻
噼	噼
噽	噽
噾	噾
噿	噿
嚀	咛
嚁	嚁
嚂	□
嚃	嚃
嚄	嚄
嚅	嚅
嚆	嚆
嚇	吓
嚈	□
嚉	□
嚊	嚊
嚋	□
嚌	哜
嚍	□
嚎	嚎
嚏	嚏
嚐	尝
嚓	嚓
嚔	嚏
嚕	噜
嚖	嚖
嚗	嚗
嚘	嚘
嚙	啮
嚚	嚚
嚛	□
嚜	嚜
嚝	□
嚞	嚞
嚟	嚟
嚠	□
嚢	嚢
嚤	嚤
嚥	咽
嚦	呖
嚧	□
嚨	咙
嚩	□
嚪	□
嚫	□
嚬	□
嚭	嚭
嚮	向
嚯	嚯
嚰	嚰
嚱	□
嚲	亸
嚳	喾
嚴	严
嚵	嚵
嚶	嘤
嚷	嚷
嚸	□
嚹	嚹
嚺	嚺
嚻	□
嚼	嚼
嚽	□
嚾	嚾
嚿	□
囀	啭
囁	嗫
囂	嚣
囃	囃
囄	□
囅	冁
囆	□
囇	□
囈	呓
囉	啰
囊	囊
囋	□
囌	苏
囍	囍
囏	囏
囐	□
囑	嘱
囒	□
囓	啮
囔	囔
囗	囗
囘	回
囚	囚
四	四
囜	囜
囝	囝
回	回
囟	囟
因	因
囡	囡
団	団
囤	囤
囥	囥
囦	囦
囧	囧
囨	囨
囩	囩
囪	囪
囫	囫
囬	回
囮	囮
囯	囯
困	困
囱	囱
囲	围
図	图
囶	囶
囷	囷
囸	囸
囹	囹
固	固
囻	囻
囼	囼
囿	囿
圀	圀
圁	圁
圂	圂
圃	圃
圄	圄
圅	圅
圇	囵
圈	圈
圉	圉
圊	圊
國	国
圌	圌
圍	围
圎	□
圏	圈
圐	圐
圑	圑
園	园
圓	圆
圔	圔
圖	图
圗	圗
團	团
圙	圙
圚	□
圛	□
圜	圜
圝	□
圞	□
土	土
圠	圠
圡	圡
圢	圢
圤	圤
圥	圥
圧	压
在	在
圩	圩
圪	圪
圫	圫
圬	圬
圭	圭
圮	圮
圯	圯
地	地
圱	圱
圲	圲
圳	圳
圴	圴
圵	圵
圶	圶
圻	圻
圼	圼
圽	圽
圾	圾
圿	圿
址	址
坁	坁
坂	坂
坃	坃
坄	坄
坅	坅
坆	坆
均	均
坈	坈
坉	坉
坊	坊
坋	坋
坌	坌
坍	坍
坎	坎
坐	坐
坑	坑
坒	坒
坓	坓
坔	坔
坕	坕
坖	坖
坘	坘
坙	坙
坡	坡
坢	坢
坣	坣
坤	坤
坥	坥
坦	坦
坧	坧
坨	坨
坩	坩
坪	坪
坫	坫
坬	坬
坭	坭
坮	坮
坯	坯
坰	坰
坱	坱
坲	坲
坳	坳
坴	坴
坵	坵
坶	坶
坷	坷
坸	坸
坹	坹
坺	坺
坻	坻
坼	坼
坽	坽
坾	坾
坿	坿
垀	垀
垁	垁
垂	垂
垃	垃
垇	垇
垉	垉
型	型
垌	垌
垍	垍
垎	垎
垏	垏
垐	垐
垑	垑
垓	垓
垔	垔
垕	垕
垖	垖
垗	垗
垘	垘
垙	垙
垚	垚
垛	垛
垜	垛
垝	垝
垞	垞
垟	垟
垠	垠
垡	垡
垢	垢
垣	垣
垤	垤
垥	垥
垧	垧
垨	垨
垬	垬
垮	垮
垵	垵
垶	垶
垷	□
垸	垸
垹	垹
垺	垺
垻	坝
垼	垼
垽	垽
垾	垾
垿	垿
埀	埀
埁	埁
埂	埂
埃	埃
埄	埄
埅	埅
埆	埆
埇	埇
埈	埈
埉	□
埊	埊
埋	埋
埌	埌
埍	埍
城	城
埏	埏
埐	埐
埑	埑
埒	埒
埓	埓
埔	埔
埕	埕
埗	埗
埛	埛
埜	埜
埝	埝
埞	埞
域	域
埠	埠
埡	垭
埢	埢
埣	埣
埤	埤
埥	埥
埦	埦
埧	埧
埨	□
埩	□
埪	埪
埫	埫
埬	□
埭	埭
埮	埮
埯	埯
埰	埰
埱	埱
埲	埲
埳	埳
埴	埴
埵	埵
埶	埶
執	执
埸	埸
培	培
基	基
埻	埻
埼	埼
埽	埽
埾	埾
埿	埿
堀	堀
堁	堁
堂	堂
堃	昆
堄	堄
堅	坚
堆	堆
堇	堇
堈	□
堉	堉
堊	垩
堋	堋
堌	堌
堍	堍
堎	堎
堐	堐
堓	堓
堖	垴
堗	堗
堘	堘
堙	堙
堚	□
堛	堛
堜	堜
堝	埚
堞	堞
堟	堟
堠	堠
堡	堡
堢	堢
堣	堣
堤	堤
堥	堥
堦	堦
堧	堧
堨	堨
堩	堩
堪	堪
堫	堫
堬	堬
堭	堭
堮	堮
堯	尧
堰	堰
報	报
堲	堲
堳	堳
場	场
堵	堵
堶	堶
堷	堷
堸	□
堹	堹
堺	堺
堻	堻
堼	堼
堽	堽
堾	堾
堿	堿
塂	塂
塃	塃
塄	塄
塅	塅
塇	塇
塈	塈
塉	塉
塊	块
塋	茔
塌	塌
塍	塍
塎	塎
塏	垲
塐	塐
塑	塑
塒	埘
塓	塓
塔	塔
塕	塕
塖	塖
塗	涂
塘	塘
塙	塙
塚	塚
塛	塛
塜	塜
塝	塝
塞	塞
塟	塟
塠	塠
塡	填
塢	坞
塣	塣
塤	埙
塥	塥
塦	□
塧	塧
塨	塨
塩	盐
塪	塪
填	填
塬	塬
塭	塭
塮	塮
塯	塯
塱	塱
塲	场
塳	塳
塴	塴
塵	尘
塶	塶
塷	□
塸	□
塹	堑
塺	塺
塻	塻
塼	□
塽	塽
塾	塾
塿	□
墀	墀
墁	墁
墂	墂
境	境
墄	墄
墅	墅
墆	□
墇	墇
墈	墈
墉	墉
墊	垫
墋	□
墌	墌
墍	墍
墎	墎
墏	□
墐	墐
墑	墑
墒	墒
墓	墓
墔	墔
墕	墕
墖	墖
増	增
墘	墘
墚	墚
墜	坠
墝	□
增	增
墟	墟
墠	□
墡	墡
墢	□
墣	□
墤	□
墥	墥
墦	墦
墧	□
墨	墨
墩	墩
墪	墪
墫	墫
墬	墬
墭	墭
墮	堕
墯	墯
墰	墰
墱	墱
墲	□
墳	坟
墴	墴
墵	□
墶	□
墷	□
墺	墺
墻	墙
墼	□
墽	墽
墾	垦
墿	□
壀	壀
壁	壁
壂	壂
壃	壃
壄	壄
壅	壅
壆	壆
壇	坛
壈	□
壉	壉
壊	坏
壋	垱
壌	壌
壍	□
壎	壎
壏	□
壐	□
壑	壑
壒	壒
壓	压
壔	□
壕	壕
壖	壖
壘	垒
壙	圹
壚	垆
壛	壛
壜	坛
壝	□
壞	坏
壟	垄
壠	垅
壡	壡
壢	坜
壣	□
壤	壤
壦	壦
壧	□
壨	壨
壩	坝
士	士
壬	壬
壯	壮
壱	壱
売	卖
壴	壴
壵	壵
壷	壶
壹	壹
壺	壶
壻	壻
壼	壸
壽	寿
壾	壾
壿	壿
夀	夀
夁	夁
夂	夂
夅	夅
夆	夆
変	变
夋	夋
夌	夌
夎	夎
夏	夏
夐	夐
夒	夒
夓	夓
夔	夔
夕	夕
外	外
夗	夗
夘	夘
夙	夙
多	多
夛	夛
夜	夜
夝	夝
夠	够
夡	夡
夢	梦
夣	夣
夤	夤
夥	伙
夥	夥
夦	夦
大	大
夨	夨
天	天
太	太
夫	夫
夬	夬
夭	夭
央	央
夯	夯
夰	夰
失	失
夲	夲
夳	夳
夵	夵
夶	夶
夷	夷
夸	夸
夼	夼
夽	夽
夾	夹
夿	夿
奀	奀
奃	奃
奄	奄
奅	奅
奆	奆
奇	奇
奈	奈
奉	奉
奊	奊
奌	奌
奎	奎
奏	奏
奐	奂
契	契
奒	奒
奓	奓
奔	奔
奕	奕
套	套
奘	奘
奙	奙
奚	奚
奛	奛
奜	奜
奝	奝
奞	奞
奟	奟
奠	奠
奡	奡
奢	奢
奣	奣
奤	奤
奦	奦
奧	奥
奨	奖
奩	奁
奪	夺
奫	□
奭	奭
奮	奋
奯	奯
奰	奰
奱	□
奲	□
女	女
奴	奴
奵	奵
奶	奶
奷	奷
奸	奸
她	她
奺	奺
奻	奻
奼	奼
好	好
奾	奾
奿	奿
妀	妀
妁	妁
如	如
妃	妃
妄	妄
妅	妅
妉	妉
妊	妊
妋	妋
妌	妌
妍	妍
妎	妎
妏	妏
妐	妐
妑	妑
妒	妒
妓	妓
妔	妔
妕	妕
妖	妖
妗	妗
妘	妘
妙	妙
妚	妚
妜	妜
妝	妆
妞	妞
妟	妟
妠	妠
妡	妡
妢	妢
妣	妣
妤	妤
妥	妥
妦	妦
妧	妧
妨	妨
妬	妬
妭	妭
妮	妮
妯	妯
妰	妰
妱	妱
妲	妲
妳	你
妴	妴
妵	妵
妶	妶
妷	妷
妸	妸
妹	妹
妺	妺
妻	妻
妼	妼
妽	妽
妾	妾
妿	妿
姀	姀
姁	姁
姂	姂
姃	姃
姄	姄
姅	姅
姆	姆
姇	姇
姈	姈
姉	姉
姊	姊
始	始
姌	姌
姍	姗
姎	姎
姏	姏
姐	姐
姑	姑
姒	姒
姓	姓
委	委
姕	姕
姖	姖
姘	姘
姙	姙
姚	姚
姛	姛
姜	姜
姝	姝
姞	姞
姟	姟
姠	姠
姡	姡
姢	姢
姣	姣
姤	姤
姥	姥
姦	奸
姧	姧
姨	姨
姩	姩
姪	姪
姫	姫
姬	姬
姭	姭
姮	姮
姯	姯
姰	姰
姱	姱
姲	姲
姳	姳
姴	姴
姵	姵
姶	姶
姷	姷
姸	姸
姹	姹
姺	姺
姻	姻
姼	姼
姽	姽
姾	姾
姿	姿
娀	娀
威	威
娂	娂
娃	娃
娉	娉
娊	□
娋	娋
娌	娌
娍	娍
娎	娎
娏	娏
娑	娑
娒	娒
娓	娓
娔	娔
娕	娕
娖	娖
娗	娗
娘	娘
娙	□
娚	娚
娛	娱
娜	娜
娝	娝
娞	娞
娟	娟
娠	娠
娡	娡
娢	娢
娣	娣
娤	□
娥	娥
娦	娦
娧	娧
娨	娨
娩	娩
娪	娪
娫	娫
娬	娬
娭	娭
娮	娮
娯	娱
娰	娰
娵	娵
娶	娶
娷	娷
娸	娸
娹	娹
娺	娺
娻	□
娼	娼
娽	娽
娾	娾
娿	娿
婀	婀
婁	娄
婂	婂
婃	婃
婄	婄
婅	婅
婆	婆
婇	婇
婈	婈
婉	婉
婊	婊
婋	婋
婌	婌
婍	婍
婎	婎
婏	婏
婐	婐
婑	婑
婒	婒
婓	婓
婕	婕
婖	婖
婗	婗
婘	婘
婙	婙
婚	婚
婛	婛
婜	□
婝	婝
婞	婞
婟	婟
婠	婠
婡	□
婢	婢
婣	婣
婤	婤
婥	婥
婦	妇
婧	婧
婨	□
婩	婩
婪	婪
婫	婫
婬	婬
婭	娅
婯	婯
婰	婰
婱	婱
婷	婷
婸	□
婹	婹
婺	婺
婻	婻
婼	婼
婽	婽
婾	婾
婿	婿
媀	媀
媁	□
媂	媂
媃	媃
媄	媄
媅	媅
媆	媆
媇	媇
媉	媉
媊	媊
媋	媋
媌	媌
媍	□
媎	媎
媏	媏
媐	媐
媑	媑
媒	媒
媓	媓
媔	媔
媕	媕
媖	媖
媗	媗
媙	媙
媚	媚
媛	媛
媜	□
媝	媝
媞	媞
媟	媟
媠	媠
媡	媡
媢	媢
媣	媣
媤	媤
媥	媥
媦	媦
媧	娲
媨	媨
媩	媩
媮	媮
媯	妫
媰	□
媱	□
媲	媲
媳	媳
媴	媴
媵	媵
媶	媶
媷	媷
媸	媸
媹	媹
媺	媺
媻	媻
媼	媪
媽	妈
媾	媾
媿	媿
嫀	嫀
嫁	嫁
嫂	嫂
嫃	嫃
嫄	嫄
嫅	嫅
嫆	嫆
嫇	嫇
嫈	□
嫉	嫉
嫊	嫊
嫋	嫋
嫌	嫌
嫍	嫍
嫎	嫎
嫏	嫏
嫐	嫐
嫑	嫑
嫓	嫓
嫕	嫕
嫖	嫖
嫗	妪
嫘	嫘
嫙	嫙
嫚	嫚
嫛	嫛
嫜	嫜
嫝	嫝
嫞	嫞
嫟	嫟
嫠	嫠
嫡	嫡
嫢	□
嫣	嫣
嫤	嫤
嫥	□
嫦	嫦
嫧	□
嫨	嫨
嫩	嫩
嫪	嫪
嫫	嫫
嫬	嫬
嫭	嫭
嫮	嫮
嫯	嫯
嫰	嫰
嫳	嫳
嫴	嫴
嫵	妩
嫶	嫶
嫷	嫷
嫸	嫸
嫹	嫹
嫺	娴
嫻	娴
嫼	嫼
嫽	嫽
嫾	嫾
嫿	婳
嬀	妫
嬁	嬁
嬂	□
嬃	媭
嬅	嬅
嬆	嬆
嬇	□
嬈	娆
嬉	嬉
嬊	嬊
嬋	婵
嬌	娇
嬍	嬍
嬎	嬎
嬏	嬏
嬐	□
嬑	嬑
嬒	□
嬓	嬓
嬔	嬔
嬕	□
嬖	嬖
嬗	嬗
嬘	嬘
嬙	嫱
嬚	嬚
嬛	嬛
嬝	□
嬞	嬞
嬟	□
嬠	嬠
嬡	嫒
嬢	娘
嬣	□
嬤	嬷
嬥	嬥
嬦	□
嬧	□
嬨	嬨
嬩	□
嬪	嫔
嬬	嬬
嬭	□
嬮	□
嬯	□
嬰	婴
嬱	□
嬲	嬲
嬴	嬴
嬵	□
嬸	婶
嬹	□
嬺	嬺
嬻	□
嬼	□
嬾	□
嬿	嬿
孀	孀
孁	孁
孂	孂
孃	娘
孄	□
孅	孅
孆	□
孇	□
孈	□
孉	孉
孊	孊
孋	□
孌	娈
孍	□
孎	□
孏	□
子	子
孑	孑
孒	孒
孓	孓
孔	孔
孕	孕
孖	孖
字	字
存	存
孚	孚
孛	孛
孜	孜
孝	孝
孞	孞
孟	孟
孠	孠
孡	孡
孢	孢
季	季
孤	孤
孥	孥
孨	孨
孩	孩
孫	孙
孬	孬
孭	□
孮	孮
孯	□
孰	孰
孱	孱
孲	□
孴	孴
孵	孵
孶	孳
孷	孷
學	学
孹	孹
孺	孺
孻	□
孼	孼
孽	孽
孾	□
孿	孪
宀	宀
宂	宂
它	它
宄	宄
宅	宅
宆	宆
宇	宇
守	守
安	安
宊	宊
宋	宋
完	完
宍	宍
宎	宎
宏	宏
宐	宐
宑	宑
宒	宒
宓	宓
宔	宔
宕	宕
宖	宖
宗	宗
官	官
宙	宙
定	定
宛	宛
宜	宜
実	实
客	客
宣	宣
室	室
宥	宥
宦	宦
宨	宨
宩	宩
宬	宬
宭	宭
宮	宫
宯	宯
宰	宰
宱	宱
宲	宲
害	害
宴	宴
宵	宵
家	家
宷	宷
宸	宸
容	容
宺	宺
宻	宻
宼	宼
宿	宿
寀	寀
寁	寁
寂	寂
寃	寃
寄	寄
寅	寅
密	密
寇	寇
寈	寈
寉	寉
寊	□
寋	寋
富	富
寍	寍
寎	寎
寏	寏
寐	寐
寑	寑
寒	寒
寓	寓
寔	寔
寕	寕
寖	寖
寗	寗
寘	寘
寙	寙
寚	寚
寛	宽
寜	宁
寞	寞
察	察
寠	□
寡	寡
寢	寝
寣	寣
寤	寤
寥	寥
實	实
寧	宁
寨	寨
審	审
寪	□
寫	写
寬	宽
寭	寭
寮	寮
寯	寯
寰	寰
寱	寱
寲	寲
寳	宝
寴	□
寵	宠
寶	宝
寷	寷
寸	寸
寺	寺
寽	寽
対	对
尀	尀
封	封
専	专
尃	尃
射	射
尅	尅
將	将
專	专
尉	尉
尊	尊
尋	寻
尌	尌
對	对
導	导
小	小
尐	尐
少	少
尒	尒
尓	尓
尕	尕
尖	尖
尗	尗
尙	尚
尚	尚
尛	尛
尜	尜
尞	尞
尟	尟
尠	尠
尢	尢
尣	尣
尤	尤
尥	尥
尦	尦
尨	尨
尩	尩
尪	尪
尫	尫
尬	尬
尭	尧
尮	尮
尯	尯
尰	尰
就	就
尲	尲
尳	尳
尵	□
尶	尴
尷	尴
尸	尸
尹	尹
尺	尺
尻	尻
尼	尼
尾	尾
尿	尿
局	局
屁	屁
屄	屄
居	居
屆	届
屇	屇
屈	屈
屋	屋
屌	屌
屍	尸
屎	屎
屏	屏
屐	屐
屑	屑
屒	屒
屓	屃
屔	屔
展	展
屖	屖
屘	屘
屙	屙
屚	屚
屛	屏
屜	屉
屝	屝
屟	屟
屠	屠
屢	屡
屣	屣
層	层
履	履
屧	屧
屨	屦
屩	□
屪	屪
屫	□
屬	属
屭	屃
屮	屮
屯	屯
屰	屰
山	山
屳	屳
屴	屴
屵	屵
屸	屸
屹	屹
屺	屺
屻	屻
屼	屼
屽	屽
屾	屾
岄	岄
岅	岅
岆	岆
岇	岇
岈	岈
岉	岉
岊	岊
岋	岋
岌	岌
岍	岍
岎	岎
岏	岏
岐	岐
岑	岑
岒	岒
岓	岓
岔	岔
岕	岕
岙	岙
岜	岜
岝	岝
岞	岞
岟	岟
岠	岠
岡	冈
岢	岢
岣	岣
岤	岤
岥	岥
岦	岦
岧	岧
岨	岨
岩	岩
岪	岪
岫	岫
岬	岬
岮	岮
岯	岯
岰	岰
岱	岱
岲	岲
岳	岳
岴	岴
岵	岵
岶	岶
岷	岷
岸	岸
岹	岹
岺	岺
岻	岻
峀	峀
峁	峁
峂	峂
峆	峆
峇	峇
峈	峈
峉	峉
峊	峊
峋	峋
峌	峌
峍	峍
峎	峎
峏	峏
峐	峐
峑	峑
峒	峒
峓	峓
峔	峔
峕	峕
峖	峖
峗	峗
峘	峘
峙	峙
峚	峚
峛	峛
峜	峜
峝	峝
峞	峞
峟	峟
峠	峠
峢	峢
峧	峧
峨	峨
峩	峨
峪	峪
峫	峫
峬	峬
峭	峭
峮	峮
峯	峯
峰	峰
峱	峱
峲	峲
峳	峳
峴	岘
峵	峵
島	岛
峷	峷
峸	峸
峹	峹
峺	峺
峻	峻
峼	峼
峽	峡
峾	峾
峿	峿
崀	崀
崁	崁
崅	崅
崆	崆
崇	崇
崈	崈
崉	崉
崌	崌
崍	崃
崎	崎
崏	崏
崐	崐
崑	昆
崒	崒
崓	崓
崔	崔
崕	崕
崖	崖
崗	岗
崘	□
崙	仑
崚	崚
崛	崛
崜	崜
崝	崝
崞	崞
崟	崟
崠	□
崡	崡
崢	峥
崣	崣
崤	崤
崥	崥
崦	崦
崧	崧
崩	崩
崪	崪
崫	崫
崬	岽
崮	崮
崯	崯
崱	□
崲	崲
崳	崳
崴	崴
崵	□
崶	崶
崷	崷
崸	□
崹	崹
崺	崺
崻	崻
崼	崼
崽	崽
崾	崾
崿	崿
嵀	嵀
嵁	嵁
嵂	嵂
嵃	嵃
嵄	嵄
嵅	嵅
嵆	嵆
嵇	嵇
嵈	嵈
嵉	嵉
嵊	嵊
嵋	嵋
嵌	嵌
嵍	嵍
嵎	嵎
嵏	嵏
嵐	岚
嵑	嵑
嵒	嵒
嵓	嵓
嵔	嵔
嵕	嵕
嵖	嵖
嵗	嵗
嵛	嵛
嵞	嵞
嵟	嵟
嵠	嵠
嵡	嵡
嵢	嵢
嵣	嵣
嵤	嵤
嵥	嵥
嵦	□
嵧	嵧
嵨	□
嵩	嵩
嵪	□
嵫	嵫
嵬	嵬
嵭	嵭
嵮	嵮
嵯	嵯
嵰	嵰
嵱	嵱
嵲	嵲
嵳	嵳
嵴	嵴
嵷	□
嵸	□
嵹	嵹
嵺	嵺
嵼	□
嵽	□
嵾	□
嵿	□
嶀	嶀
嶁	嵝
嶂	嶂
嶃	□
嶄	崭
嶅	嶅
嶆	嶆
嶇	岖
嶈	□
嶉	嶉
嶊	嶊
嶋	□
嶌	□
嶍	嶍
嶎	嶎
嶏	嶏
嶐	嶐
嶑	嶑
嶒	嶒
嶓	嶓
嶔	嵚
嶕	嶕
嶖	嶖
嶗	崂
嶘	□
嶙	嶙
嶚	嶚
嶛	嶛
嶜	嶜
嶝	嶝
嶞	嶞
嶟	嶟
嶠	峤
嶡	嶡
嶢	峣
嶣	嶣
嶤	□
嶥	嶥
嶦	嶦
嶧	峄
嶨	峃
嶩	□
嶪	□
嶫	□
嶬	□
嶭	嶭
嶮	崄
嶯	嶯
嶰	嶰
嶱	嶱
嶲	隽
嶳	嶳
嶴	□
嶵	嶵
嶷	嶷
嶸	嵘
嶹	□
嶺	岭
嶻	嶻
嶼	屿
嶽	岳
嶾	□
巀	巀
巁	□
巂	巂
巃	□
巄	□
巆	□
巇	□
巈	巈
巉	巉
巊	□
巋	岿
巌	岩
巍	巍
巎	巎
巏	巏
巐	巐
巑	□
巒	峦
巓	巓
巔	巅
巖	□
巗	□
巘	□
巙	巙
巚	□
川	川
州	州
巟	巟
巠	巠
巡	巡
巢	巢
巣	巢
巤	巤
工	工
左	左
巧	巧
巨	巨
巫	巫
差	差
巰	巯
己	己
已	已
巳	巳
巴	巴
巵	巵
巶	巶
巷	巷
巹	巹
巺	巺
巻	卷
巽	巽
巾	巾
巿	巿
帀	帀
市	市
布	布
帄	帄
帆	帆
帇	帇
帉	帉
帊	帊
帋	帋
希	希
帍	帍
帎	帎
帑	帑
帒	帒
帓	帓
帔	帔
帕	帕
帖	帖
帗	帗
帘	帘
帙	帙
帚	帚
帛	帛
帝	帝
帞	帞
帟	帟
帠	帠
帢	帢
帣	帣
帤	帤
帥	帅
帨	帨
帩	帩
帪	帪
師	师
帬	帬
席	席
帯	帯
帲	帡
帳	帐
帴	□
帵	帵
帶	带
帷	帷
常	常
帹	帹
帺	帺
帽	帽
帾	帾
帿	帿
幀	帧
幁	□
幃	帏
幄	幄
幅	幅
幆	幆
幇	帮
幈	幈
幊	□
幋	幋
幌	幌
幍	幍
幎	幎
幏	幏
幐	幐
幑	幑
幒	幒
幓	□
幔	幔
幕	幕
幖	幖
幗	帼
幘	帻
幙	幙
幚	幚
幛	幛
幜	幜
幝	□
幞	幞
幟	帜
幠	□
幡	幡
幢	幢
幣	币
幦	幦
幧	幧
幨	幨
幩	□
幪	幪
幫	帮
幬	帱
幭	幭
幮	幮
幯	□
幰	□
幱	□
干	干
平	平
年	年
幵	幵
幸	幸
幹	干
幻	幻
幼	幼
幽	幽
幾	几
庀	庀
庁	厅
庂	庂
広	广
庅	庅
庇	庇
庈	庈
庉	庉
床	床
庋	庋
庌	庌
庍	庍
庎	庎
序	序
底	底
庖	庖
店	店
庘	庘
庚	庚
庛	庛
府	府
庝	庝
庠	庠
庡	庡
庢	庢
庣	庣
庤	庤
庥	庥
度	度
座	座
庨	庨
庩	庩
庪	庪
庫	库
庬	庬
庭	庭
庮	庮
庯	庯
庰	庰
庱	庱
庲	□
庳	庳
庴	庴
庵	庵
庶	庶
康	康
庸	庸
庹	庹
庺	庺
庻	庻
庽	庽
庾	庾
庿	庿
廀	廀
廁	厕
廂	厢
廃	废
廄	厩
廅	廅
廆	廆
廇	廇
廈	厦
廉	廉
廊	廊
廋	廋
廌	廌
廍	廍
廎	庼
廏	廏
廐	廐
廑	廑
廒	廒
廓	廓
廔	□
廕	□
廖	廖
廗	□
廘	廘
廙	□
廚	厨
廛	廛
廜	廜
廝	厮
廞	□
廟	庙
廠	厂
廡	庑
廢	废
廣	广
廥	□
廦	廦
廧	□
廨	廨
廩	廪
廫	□
廬	庐
廮	□
廯	□
廰	厅
廱	廱
廲	□
廳	厅
廵	廵
延	延
廷	廷
廸	廸
廹	廹
建	建
廻	廻
廼	乃
廽	廻
廾	廾
廿	廿
弁	弁
弄	弄
弅	弅
弆	弆
弇	弇
弈	弈
弉	□
弊	弊
弋	弋
弌	弌
弍	弍
弎	弎
式	式
弐	弐
弒	弑
弓	弓
弔	吊
引	引
弖	弖
弗	弗
弘	弘
弙	弙
弚	弚
弛	弛
弜	弜
弝	弝
弞	弞
弟	弟
弡	弡
弢	弢
弣	弣
弤	弤
弦	弦
弧	弧
弨	弨
弩	弩
弫	弫
弭	弭
弮	弮
弰	弰
弱	弱
弲	弲
弳	弪
弴	弴
張	张
弶	弶
強	强
弸	弸
弻	弻
弼	弼
弽	弽
弾	弹
弿	弿
彀	彀
彂	彂
彃	□
彄	□
彆	别
彇	□
彈	弹
彉	彉
彊	彊
彋	彋
彌	弥
彍	□
彎	弯
彏	彏
彔	录
彖	彖
彗	彗
彘	彘
彙	汇
彚	彚
彜	彛
彞	彝
彠	彟
彡	彡
形	形
彣	彣
彤	彤
彥	彦
彧	彧
彩	彩
彪	彪
彫	雕
彬	彬
彭	彭
彮	彮
彯	彯
彰	彰
影	影
彲	彨
彳	彳
彴	彴
彵	彵
彶	彶
彷	仿
彸	彸
役	役
彺	彺
彼	彼
彽	彽
彾	彾
彿	彿
往	往
征	征
徂	徂
徃	徃
待	待
徆	徆
徇	徇
很	很
徉	徉
徊	徊
律	律
後	后
徍	徍
徎	徎
徏	徏
徐	徐
徑	径
徒	徒
従	从
徖	徖
得	得
徘	徘
徙	徙
徛	徛
徜	徜
徝	徝
從	从
徟	徟
徠	徕
御	御
徢	徢
徣	徣
徤	徤
徥	徥
徦	徦
徧	徧
徨	徨
復	复
循	循
徫	□
徬	徬
徭	□
微	微
徯	徯
徰	徰
徱	徱
徲	徲
徳	德
徴	徴
徵	征
徶	徶
德	德
徸	徸
徹	彻
徺	□
徻	□
徼	徼
徽	徽
徾	徾
徿	□
忀	忀
忁	忁
忂	忂
心	心
必	必
忇	忇
忈	忈
忉	忉
忊	忊
忋	忋
忌	忌
忍	忍
忎	忎
忐	忐
忑	忑
忒	忒
忓	忓
忔	忔
忕	忕
忖	忖
志	志
忘	忘
忙	忙
忚	忚
忛	忛
応	应
忝	忝
忞	忞
忟	忟
忠	忠
忡	忡
忢	忢
忣	忣
忤	忤
忥	忥
忦	忦
忨	忨
忩	忩
忪	忪
快	快
忬	忬
忭	忭
忮	忮
忯	忯
忰	忰
忱	忱
忲	忲
忳	忳
忴	忴
念	念
忶	忶
忷	忷
忸	忸
忹	忹
忺	忺
忻	忻
忼	忼
忽	忽
忿	忿
怇	怇
怈	怈
怉	怉
怊	怊
怋	怋
怌	怌
怍	怍
怎	怎
怏	怏
怐	怐
怑	怑
怒	怒
怓	怓
怔	怔
怕	怕
怖	怖
怗	怗
怘	怘
怙	怙
怚	怚
怛	怛
思	思
怞	怞
怟	怟
怠	怠
怡	怡
怢	怢
怣	怣
怤	怤
急	急
怦	怦
性	性
怨	怨
怩	怩
怪	怪
怫	怫
怬	怬
怭	怭
怮	怮
怯	怯
怰	怰
怱	怱
怲	怲
怳	怳
怴	怴
怵	怵
怶	怶
怷	怷
怸	怸
怹	怹
恀	恀
恁	恁
恂	恂
恃	恃
恄	恄
恅	恅
恆	恒
恇	恇
恈	恈
恉	恉
恊	恊
恌	恌
恍	恍
恎	恎
恏	恏
恐	恐
恑	恑
恓	恓
恔	恔
恕	恕
恗	恗
恘	恘
恙	恙
恚	恚
恛	恛
恜	恜
恝	恝
恞	恞
恟	恟
恠	恠
恡	恡
恢	恢
恣	恣
恤	恤
恥	耻
恦	恦
恧	恧
恨	恨
恩	恩
恪	恪
恫	恫
恬	恬
恭	恭
恮	恮
息	息
恰	恰
恱	恱
恲	恲
恴	恴
恵	惠
恾	恾
悀	悀
悁	悁
悂	悂
悃	悃
悄	悄
悅	悦
悆	悆
悇	悇
悈	悈
悉	悉
悊	悊
悋	悋
悌	悌
悍	悍
悎	悎
悏	□
悐	悐
悑	悑
悒	悒
悓	□
悔	悔
悕	悕
悖	悖
悗	悗
悘	悘
悙	悙
悚	悚
悛	悛
悜	悜
悝	悝
悞	悮
悟	悟
悠	悠
悡	悡
悢	悢
患	患
悤	悤
悥	悥
悧	悧
您	您
悩	恼
悪	恶
悰	悰
悱	悱
悲	悲
悳	悳
悴	悴
悵	怅
悶	闷
悷	悷
悸	悸
悹	悹
悺	悺
悻	悻
悼	悼
悽	悽
悾	悾
悿	悿
惀	□
惁	惁
惂	惂
惃	惃
惄	惄
情	情
惆	惆
惇	惇
惈	惈
惉	惉
惋	惋
惌	惌
惍	惍
惎	惎
惏	惏
惐	惐
惑	惑
惒	惒
惓	惓
惔	惔
惕	惕
惖	惖
惗	惗
惘	惘
惙	惙
惚	惚
惛	惛
惜	惜
惝	惝
惞	惞
惟	惟
惠	惠
惡	恶
惢	惢
惣	惣
惤	惤
惥	惥
惦	惦
惪	惪
惰	惰
惱	恼
惲	恽
想	想
惴	惴
惵	惵
惶	惶
惷	惷
惸	惸
惹	惹
惺	惺
惻	恻
惼	惼
惽	惽
惾	惾
惿	惿
愀	愀
愁	愁
愂	愂
愃	愃
愄	愄
愅	愅
愆	愆
愇	□
愈	愈
愉	愉
愊	愊
愋	愋
愌	□
愍	愍
愎	愎
意	意
愐	愐
愑	愑
愒	愒
愓	□
愔	愔
愕	愕
愖	愖
愗	愗
愘	愘
愙	愙
愚	愚
愛	爱
愜	惬
愝	愝
愞	愞
感	感
愡	愡
愢	愢
愣	愣
愧	愧
愨	愨
愩	□
愪	□
愫	愫
愬	愬
愭	愭
愮	□
愯	愯
愰	愰
愱	愱
愲	愲
愳	愳
愴	怆
愵	愵
愶	愶
愷	恺
愸	□
愹	愹
愺	愺
愻	□
愼	慎
愽	愽
愾	忾
慀	慀
慁	慁
慂	恿
慃	慃
慄	栗
慅	慅
慆	慆
慇	慇
慈	慈
慉	慉
慊	慊
態	态
慌	慌
慍	愠
慎	慎
慏	慏
慒	慒
慓	慓
慔	慔
慕	慕
慖	□
慗	慗
慘	惨
慙	□
慚	惭
慛	慛
慜	慜
慝	慝
慞	慞
慟	恸
慠	慠
慡	慡
慢	慢
慣	惯
慤	悫
慥	慥
慦	慦
慧	慧
慨	慨
慩	□
慪	怄
慫	怂
慬	慬
慮	虑
慯	□
慰	慰
慱	□
慲	□
慳	悭
慴	慴
慵	慵
慶	庆
慷	慷
慸	□
慹	□
慺	㥪
慻	慻
慼	慼
慽	慽
慾	欲
憀	憀
憁	憁
憂	忧
憃	憃
憄	憄
憅	憅
憆	憆
憇	憇
憈	□
憉	憉
憊	惫
憋	憋
憌	□
憍	□
憎	憎
憏	憏
憐	怜
憑	凭
憒	愦
憓	憓
憔	憔
憕	憕
憖	慭
憗	□
憘	憘
憙	憙
憚	惮
憛	憛
憜	憜
憝	憝
憞	憞
憟	憟
憠	憠
憡	憡
憢	□
憣	憣
憤	愤
憥	□
憦	□
憧	憧
憨	憨
憩	憩
憪	□
憫	悯
憬	憬
憭	憭
憮	怃
憯	憯
憰	憰
憱	憱
憲	宪
憳	□
憴	□
憵	憵
憶	忆
憷	憷
憸	□
憹	□
憺	憺
憻	憻
憼	憼
憽	憽
憾	憾
憿	憿
懀	懀
懁	懁
懂	懂
懃	懃
懄	懄
懅	懅
懆	懆
懇	恳
懈	懈
應	应
懊	懊
懋	懋
懌	怿
懍	懔
懎	□
懏	懏
懐	怀
懓	□
懕	□
懖	□
懗	懗
懘	□
懙	□
懚	□
懛	□
懜	□
懝	懝
懞	懞
懟	怼
懠	□
懡	□
懢	□
懣	懑
懤	懤
懥	懥
懦	懦
懧	□
懨	恹
懩	懩
懪	懪
懫	□
懬	□
懭	□
懮	懮
懯	懯
懰	□
懱	懱
懲	惩
懴	懴
懵	懵
懶	懒
懷	怀
懸	悬
懹	懹
懺	忏
懻	懻
懼	惧
懽	懽
懾	慑
懿	懿
戀	恋
戁	□
戂	戂
戃	□
戄	戄
戅	□
戇	戆
戈	戈
戊	戊
戌	戌
戍	戍
戎	戎
成	成
我	我
戒	戒
戓	戓
戔	戋
戕	戕
或	或
戙	戙
戚	戚
戛	戛
戜	戜
戝	□
戞	戞
戟	戟
戠	戠
戡	戡
戢	戢
戣	戣
戤	戤
戥	戥
戦	战
戧	戗
戨	戨
戩	戬
截	截
戫	戫
戭	戭
戮	戮
戰	战
戱	戯
戲	戏
戳	戳
戴	戴
戵	戵
戶	户
戸	戸
戹	戹
戺	戺
戻	戻
戼	戼
戽	戽
戾	戾
房	房
所	所
扁	扁
扂	扂
扃	扃
扄	扄
扅	扅
扆	扆
扇	扇
扈	扈
扉	扉
扊	扊
手	手
扌	扌
才	才
扎	扎
扏	扏
扐	扐
扒	扒
打	打
扔	扔
払	拂
扗	扗
托	托
扙	扙
扚	扚
扛	扛
扜	扜
扝	扝
扞	扞
扟	扟
扠	扠
扡	扡
扢	扢
扣	扣
扤	扤
扥	扥
扦	扦
扨	扨
扭	扭
扮	扮
扯	扯
扱	扱
扲	扲
扳	扳
扴	扴
扵	扵
扶	扶
扸	扸
批	批
扺	扺
扻	扻
扼	扼
扽	扽
找	找
承	承
技	技
抁	抁
抂	抂
抃	抃
抄	抄
抅	抅
抆	抆
抇	抇
抈	抈
抉	抉
把	把
抋	抋
抌	抌
抍	抍
抎	抎
抏	抏
抐	抐
抑	抑
抒	抒
抓	抓
抔	抔
投	投
抖	抖
抗	抗
折	折
抙	抙
抜	抜
抝	抝
択	择
抦	抦
抧	抧
抨	抨
抩	抩
抪	抪
披	披
抬	抬
抭	抭
抮	抮
抯	抯
抰	抰
抱	抱
抲	抲
抳	抳
抴	抴
抵	抵
抶	抶
抷	抷
抸	抸
抹	抹
抺	抺
抻	抻
押	押
抽	抽
抾	抾
抿	抿
拀	拀
拁	拁
拂	拂
拃	拃
拄	拄
拆	拆
拇	拇
拈	拈
拉	拉
拊	拊
拋	抛
拌	拌
拍	拍
拎	拎
拏	拏
拐	拐
拑	拑
拒	拒
拓	拓
拔	拔
拕	拕
拖	拖
拗	拗
拘	拘
拙	拙
拚	拚
招	招
拜	拜
拝	拜
拞	拞
拠	拠
拡	扩
拪	拪
拫	拫
括	括
拭	拭
拮	拮
拯	拯
拰	拰
拱	拱
拲	拲
拳	拳
拴	拴
拵	拵
拶	拶
拷	拷
拸	拸
拹	拹
拺	拺
拻	拻
拼	拼
拽	拽
拾	拾
拿	拿
挀	挀
持	持
挃	挃
挄	挄
挅	挆
挆	挆
指	指
挈	挈
按	按
挊	挊
挋	挋
挌	挌
挍	挍
挎	挎
挏	挏
挐	挐
挑	挑
挒	挒
挓	挓
挔	挔
挕	挕
挖	挖
挗	挗
挨	挨
挩	捝
挪	挪
挫	挫
挬	挬
挭	挭
挮	挮
振	振
挰	挰
挱	挱
挲	挲
挳	□
挴	挴
挵	挵
挶	挶
挷	挷
挸	□
挹	挹
挺	挺
挻	挻
挼	挼
挽	挽
挾	挟
捀	捀
捁	捁
捃	捃
捄	捄
捅	捅
捆	捆
捇	捇
捈	捈
捉	捉
捊	捊
捋	捋
捌	捌
捍	捍
捎	捎
捏	捏
捐	捐
捑	捑
捒	捒
捓	捓
捔	捔
捕	捕
捖	捖
捗	捗
捘	捘
捙	□
捚	捚
捛	捛
捜	捜
捠	捠
捥	捥
捦	捦
捧	捧
捨	舍
捩	捩
捪	捪
捫	扪
捬	捬
捭	捭
据	据
捯	捯
捰	捰
捱	挨
捲	捲
捳	捳
捴	搃
捵	捵
捶	捶
捷	捷
捸	捸
捹	捹
捺	捺
捻	捻
捼	捼
捽	捽
捾	捾
捿	捿
掀	掀
掁	□
掂	掂
掃	扫
掄	抡
掅	掅
掆	□
掇	掇
授	授
掉	掉
掊	掊
掋	掋
掌	掌
掍	掍
掎	掎
掏	掏
掐	掐
掑	掑
排	排
掓	掓
掔	□
掕	掕
掖	掖
掗	挜
掘	掘
掙	挣
掚	□
掛	挂
掜	掜
掝	掝
掞	掞
掟	掟
掠	掠
採	采
探	探
掣	掣
掤	掤
接	接
掦	掦
控	控
推	推
掩	掩
措	措
掫	掫
掬	掬
掭	掭
掮	掮
掯	掯
掰	掰
掱	掱
掲	掲
掹	掹
掻	掻
掽	掽
掾	掾
掿	掿
揀	拣
揁	□
揂	揂
揃	揃
揄	揄
揅	揅
揆	揆
揇	揇
揈	揈
揉	揉
揊	揊
揋	揋
揌	揌
揍	揍
揎	揎
描	描
提	提
揑	揑
插	插
揓	揓
揔	搃
揕	揕
揖	揖
揗	揗
揘	揘
揙	揙
揚	扬
換	换
揜	揜
揝	揝
揞	揞
揟	揟
揠	揠
握	握
揢	揢
揣	揣
揤	揤
揥	揥
揦	揦
揧	揧
揨	揨
揩	揩
揪	揪
揫	揫
揬	揬
揭	揭
揮	挥
揯	搄
揰	揰
揱	揱
揲	揲
揳	揳
援	援
揵	揵
揶	揶
揷	揷
揸	揸
揹	背
揺	揺
揼	揼
搆	搆
搇	搇
搈	搈
搉	搉
搊	搊
搋	搋
搌	搌
損	损
搎	□
搏	搏
搐	搐
搑	搑
搒	搒
搓	搓
搔	搔
搕	搕
搖	摇
搗	捣
搘	搘
搙	搙
搚	搚
搛	搛
搜	搜
搝	搝
搞	搞
搟	□
搠	搠
搡	搡
搢	□
搣	搣
搤	搤
搥	捶
搦	搦
搧	搧
搨	搨
搪	搪
搫	搫
搬	搬
搭	搭
搮	搮
搯	搯
搰	搰
搱	搱
搲	搲
搳	搳
搴	搴
搵	揾
搶	抢
搷	搷
搸	搸
搹	搹
搻	搻
搼	搼
搽	搽
搾	搾
搿	搿
摀	捂
摁	摁
摂	摄
摃	□
摉	摉
摋	□
摌	□
摍	摍
摎	摎
摏	摏
摐	摐
摑	掴
摒	摒
摓	摓
摔	摔
摕	□
摖	摖
摘	摘
摙	□
摚	摚
摛	摛
摜	掼
摝	摝
摞	摞
摟	搂
摠	搃
摡	摡
摢	摢
摣	摣
摤	摤
摥	□
摦	摦
摧	摧
摨	摨
摩	摩
摪	□
摫	□
摬	摬
摭	摭
摮	摮
摯	挚
摰	□
摱	摱
摲	□
摳	抠
摴	摴
摵	摵
摶	抟
摷	摷
摸	摸
摹	摹
摺	折
摻	掺
摼	□
摽	摽
摾	摾
摿	摿
撀	撀
撁	□
撂	撂
撃	□
撅	撅
撆	撆
撇	撇
撈	捞
撉	撉
撊	□
撋	□
撌	□
撍	撍
撎	撎
撏	挦
撐	撑
撒	撒
撓	挠
撔	撔
撕	撕
撖	撖
撗	撗
撘	撘
撙	撙
撚	撚
撛	撛
撜	撜
撝	□
撞	撞
撟	挢
撠	撠
撡	撡
撢	撢
撣	掸
撤	撤
撥	拨
撦	撦
撧	□
撨	撨
撩	撩
撪	□
撫	抚
撬	撬
播	播
撮	撮
撰	撰
撱	撱
撲	扑
撳	揿
撴	撴
撹	搅
撻	挞
撼	撼
撽	撽
撾	挝
撿	捡
擀	擀
擁	拥
擂	擂
擃	□
擄	掳
擅	擅
擆	撯
擇	择
擈	□
擉	擉
擊	击
擋	挡
擌	□
操	操
擎	擎
擏	擏
擐	擐
擑	擑
擒	擒
擓	□
擔	担
擕	携
擖	擖
擗	擗
擘	擘
擙	扷
據	据
擛	擛
擝	擝
擟	□
擠	挤
擡	抬
擢	擢
擣	□
擤	擤
擥	□
擦	擦
擧	挙
擨	擨
擩	擩
擪	□
擫	□
擬	拟
擭	擭
擮	擮
擯	摈
擰	拧
擱	搁
擲	掷
擳	□
擴	扩
擵	擵
擶	擶
擷	撷
擸	擸
擹	擹
擺	摆
擻	擞
擼	撸
擽	□
擾	扰
擿	□
攀	攀
攁	攁
攂	攂
攃	攃
攄	摅
攅	□
攆	撵
攇	□
攈	攈
攉	攉
攊	□
攋	□
攌	攌
攍	攍
攎	□
攏	拢
攐	攐
攑	□
攓	攓
攔	拦
攕	攕
攖	撄
攗	攗
攘	攘
攙	搀
攛	撺
攜	携
攝	摄
攞	□
攟	攟
攠	攠
攡	□
攢	攒
攣	挛
攤	摊
攥	攥
攦	□
攧	□
攨	攨
攩	□
攪	搅
攫	攫
攬	揽
攭	攭
攮	攮
支	支
攰	攰
攱	攱
攲	攲
攳	□
攴	攴
攵	攵
收	收
攷	攷
攸	攸
改	改
攺	攺
攻	攻
攼	攼
攽	攽
放	放
政	政
敀	敀
敁	敁
敂	敂
敃	敃
敄	敄
故	故
敆	敆
敇	敇
效	效
敉	敉
敊	敊
敋	敋
敍	敍
敎	教
敏	敏
敐	敐
救	救
敒	敒
敓	敚
敔	敔
敕	敕
敖	敖
敗	败
敘	叙
教	教
敜	敜
敝	敝
敞	敞
敟	敟
敠	敠
敡	敡
敢	敢
散	散
敤	敤
敥	敥
敦	敦
敧	敧
敨	敨
敪	敪
敫	敫
敬	敬
敭	敭
敮	敮
敯	敯
敱	敱
敲	敲
敳	□
整	整
敵	敌
敶	□
敷	敷
數	数
敹	敹
敺	□
敻	敻
敼	敼
敽	□
敿	□
斀	斀
斁	□
斂	敛
斃	毙
斄	□
斅	敩
斆	敩
文	文
斈	斈
斉	齐
斊	斊
斌	斌
斍	□
斎	斋
斐	斐
斑	斑
斒	斒
斔	斔
斕	斓
斖	斖
斗	斗
斘	斘
料	料
斚	斚
斛	斛
斜	斜
斝	斝
斞	斞
斟	斟
斠	斠
斡	斡
斢	斢
斣	斣
斤	斤
斥	斥
斦	斦
斧	斧
斨	斨
斪	斪
斫	斫
斬	斩
斮	斮
斯	斯
新	新
斱	斱
斳	斳
斴	斴
斵	斵
斶	斶
斷	断
斸	□
方	方
斺	斺
斻	斻
於	于
施	施
斾	斾
斿	斿
旁	旁
旂	旂
旃	旃
旄	旄
旅	旅
旆	旆
旇	旇
旈	旈
旉	旉
旊	旊
旋	旋
旌	旌
旍	旍
旎	旎
族	族
旐	旐
旑	旑
旒	旒
旓	旓
旔	旔
旖	旖
旗	旗
旘	□
旙	旙
旚	旚
旛	旛
旜	旜
旝	旝
旞	旞
旟	□
旡	旡
既	既
旣	旣
旤	□
日	日
旦	旦
旨	旨
早	早
旪	旪
旫	旫
旬	旬
旭	旭
旮	旮
旯	旯
旰	旰
旱	旱
旲	旲
旳	旳
旴	旴
旵	旵
旹	旹
旺	旺
旻	旻
旼	旼
旽	旽
旾	旾
旿	旿
昀	昀
昁	昁
昂	昂
昃	昃
昄	昄
昅	昅
昆	昆
昇	昇
昈	昈
昉	昉
昊	昊
昋	昋
昌	昌
昍	昍
明	明
昏	昏
昐	昐
昑	昑
昒	昒
易	易
昔	昔
昕	昕
昖	昖
昗	昗
昘	昘
昚	昚
昛	昛
昜	昜
昝	昝
昞	昞
星	星
映	映
昡	昡
昢	昢
昣	昣
昤	昤
春	春
昦	昦
昧	昧
昨	昨
昩	昩
昪	昪
昫	昫
昬	昬
昭	昭
昮	昮
是	是
昰	昰
昱	昱
昲	昲
昳	昳
昴	昴
昶	昶
昷	昷
昸	昸
昹	昹
昺	昺
昻	昻
昿	旷
晀	晀
晁	晁
時	时
晃	晃
晄	晄
晅	晅
晆	晆
晇	晇
晈	晈
晉	晋
晊	晊
晌	晌
晍	晍
晎	晎
晏	晏
晐	晐
晑	晑
晗	晗
晘	晘
晙	晙
晚	晚
晛	□
晜	晜
晝	昼
晞	晞
晟	晟
晠	晠
晡	晡
晢	晢
晣	晣
晤	晤
晥	晥
晦	晦
晧	晧
晨	晨
晩	晩
晪	晪
晫	晫
晬	晬
晭	晭
普	普
景	景
晰	晰
晱	晱
晲	晲
晳	晳
晴	晴
晵	晵
晶	晶
晷	晷
晸	晸
晹	晹
智	智
晻	晻
晼	晼
晽	晽
晾	晾
晿	晿
暀	暀
暁	晓
暄	暄
暅	暅
暆	暆
暇	暇
暈	晕
暉	晖
暊	□
暋	暋
暌	暌
暍	暍
暎	暎
暏	暏
暐	□
暑	暑
暒	暒
暓	暓
暔	暔
暕	暕
暖	暖
暗	暗
暘	旸
暙	暙
暚	暚
暛	暛
暜	暜
暝	暝
暞	暞
暟	□
暠	暠
暡	暡
暢	畅
暣	□
暤	暤
暥	暥
暦	暦
暨	暨
暩	暩
暪	□
暫	暂
暬	□
暭	暭
暮	暮
暯	暯
暰	□
暱	昵
暲	暲
暳	暳
暴	暴
暵	暵
暶	暶
暷	□
暸	暸
暹	暹
暺	暺
暻	暻
暼	暼
暽	暽
暾	暾
暿	暿
曀	曀
曁	曁
曂	曂
曃	曃
曄	晔
曅	□
曆	历
曇	昙
曈	曈
曉	晓
曊	□
曋	曋
曌	曌
曍	曍
曎	□
曏	□
曐	曐
曑	曑
曒	曒
曓	曓
曔	曔
曕	曕
曖	暧
曗	□
曘	曘
曙	曙
曚	曚
曛	曛
曜	曜
曝	曝
曞	□
曟	曟
曠	旷
曡	曡
曣	曣
曤	曤
曥	□
曦	曦
曧	曧
曨	昽
曩	曩
曪	□
曫	□
曬	晒
曭	□
曮	□
曯	□
曰	曰
曱	曱
曲	曲
曳	曳
更	更
曵	曵
曶	曶
曷	曷
書	书
曹	曹
曺	曺
曼	曼
曽	曽
曾	曾
替	替
最	最
朁	朁
朂	朂
會	会
朄	□
朅	朅
朆	朆
朇	□
月	月
有	有
朊	朊
朋	朋
朌	朌
服	服
朎	朎
朏	朏
朐	朐
朒	朒
朓	朓
朔	朔
朕	朕
朖	朖
朗	朗
朘	朘
朙	朙
朚	朚
望	望
朜	朜
朝	朝
朞	朞
期	期
朠	朠
朡	朡
朢	□
朣	朣
朤	朤
朦	朦
朧	胧
木	木
朩	朩
未	未
末	末
本	本
札	札
朮	朮
朱	朱
朲	朲
朳	朳
朴	朴
朵	朵
朶	朵
朷	朷
朸	朸
朹	朹
朻	朻
朼	朼
朽	朽
朾	朾
朿	朿
杄	杄
杅	杅
杆	杆
杇	杇
杈	杈
杉	杉
杊	杊
杋	杋
杌	杌
杍	杍
李	李
杏	杏
材	材
村	村
杒	杒
杓	杓
杔	杔
杕	杕
杖	杖
杗	杗
杘	杘
杙	杙
杚	杚
杛	杛
杜	杜
杝	杝
杞	杞
束	束
杠	杠
杧	杧
杪	杪
杫	杫
杬	杬
杭	杭
杮	杮
杯	杯
杰	杰
東	东
杲	杲
杳	杳
杴	杴
杵	杵
杶	杶
杷	杷
杸	杸
杹	杹
杺	杺
杻	杻
杼	杼
杽	杽
松	松
板	板
枀	枀
枂	枂
枃	枃
枅	枅
枆	枆
枇	枇
枈	枈
枉	枉
枊	枊
枋	枋
枌	枌
枍	枍
枎	枎
枏	枏
析	析
枑	枑
枒	枒
枓	枓
枔	枔
枕	枕
枖	枖
林	林
枘	枘
枙	枙
枚	枚
枛	枛
果	果
枝	枝
枡	枡
枬	枬
枮	枮
枯	枯
枰	枰
枱	台
枲	枲
枳	枳
枵	枵
架	架
枷	枷
枸	枸
枹	枹
枺	枺
枻	枻
枼	枼
枽	枽
枾	枾
枿	枿
柀	柀
柁	柁
柂	柂
柃	柃
柄	柄
柅	柅
柆	柆
柇	柇
柈	柈
柉	柉
柊	柊
柋	柋
柌	柌
柍	柍
柎	柎
柏	柏
某	某
柑	柑
柒	柒
染	染
柔	柔
柕	柕
柖	柖
柗	柗
柘	柘
柙	柙
柚	柚
柛	柛
柝	柝
柞	柞
柟	柟
柡	柡
柢	柢
柣	柣
柤	柤
查	查
柦	柦
柧	柧
柩	柩
柪	柪
柫	柫
柬	柬
柭	柭
柮	柮
柯	柯
柰	柰
柱	柱
柲	柲
柳	柳
柴	柴
柵	栅
柶	柶
柷	柷
柸	柸
柹	柹
柺	拐
査	査
柼	柼
柾	柾
柿	柿
栀	栀
栁	栁
栂	栂
栄	荣
栐	栐
栒	栒
栓	栓
栔	栔
栕	栕
栗	栗
栘	栘
栙	栙
栚	栚
栛	栛
栜	栜
栝	栝
栞	栞
栟	栟
栠	栠
校	校
栢	栢
栣	栣
栤	栤
栥	栥
栦	栦
栧	栧
栨	栨
栩	栩
株	株
栫	栫
栬	栬
栭	栭
栮	栮
栯	栯
栰	栰
栱	栱
栲	栲
栳	栳
栴	栴
栵	栵
核	核
根	根
栺	栺
栻	栻
格	格
栽	栽
栿	栿
桀	桀
桁	桁
桂	桂
桃	桃
桄	桄
桅	桅
框	框
桇	桇
案	案
桉	桉
桊	桊
桋	桋
桌	桌
桍	桍
桎	桎
桏	桏
桐	桐
桑	桑
桒	桒
桓	桓
桔	桔
桕	桕
桖	桖
桗	桗
桘	桘
桙	桙
桚	桚
桜	樱
桟	栈
桫	桫
桬	桬
桭	桭
桮	桮
桯	桯
桰	桰
桱	□
桲	桲
桳	桳
桴	桴
桵	桵
桶	桶
桷	桷
桸	桸
桹	桹
桺	桺
桻	桻
桼	桼
桽	桽
桾	桾
桿	杆
梀	梀
梁	梁
梂	梂
梃	梃
梄	梄
梅	梅
梆	梆
梇	梇
梈	梈
梉	□
梊	梊
梋	梋
梌	梌
梍	梍
梎	梎
梏	梏
梐	梐
梑	梑
梒	梒
梓	梓
梔	梔
梕	梕
梖	□
梗	梗
梘	枧
梙	梙
梚	梚
梛	梛
梜	□
條	条
梞	梞
梟	枭
梠	□
梡	梡
梢	梢
梣	梣
梤	梤
梥	梥
梧	梧
梨	梨
梩	梩
梪	梪
梫	梫
梬	梬
梭	梭
梮	梮
梯	梯
械	械
梱	梱
梲	棁
梳	梳
梴	梴
梵	梵
梶	梶
梷	梷
梸	梸
梹	梹
梽	梽
棃	棃
棄	弃
棅	棅
棆	□
棇	棇
棈	棈
棉	棉
棊	棊
棋	棋
棌	棌
棍	棍
棎	棎
棏	棏
棐	棐
棑	棑
棒	棒
棓	棓
棔	棔
棕	棕
棖	枨
棗	枣
棘	棘
棙	棙
棚	棚
棛	棛
棜	□
棝	棝
棞	棞
棟	栋
棠	棠
棡	□
棢	棢
棣	棣
棤	棤
棥	棥
棦	□
棧	栈
棨	棨
棩	□
棪	棪
棫	棫
棬	棬
棭	棭
森	森
棯	棯
棰	棰
棱	棱
棲	栖
棳	棳
棴	棴
棵	棵
棶	梾
棷	棷
棸	棸
棹	棹
棺	棺
棻	棻
棼	棼
棽	棽
棾	棾
棿	棿
椀	椀
椁	椁
椂	椂
椃	椃
椄	椄
椅	椅
椆	椆
椇	椇
椈	椈
椉	椉
椊	椊
椋	椋
椌	椌
植	植
椎	椎
椏	桠
椐	椐
椑	椑
椒	椒
椓	椓
椔	椔
椕	椕
椖	椖
椗	椗
椘	椘
検	检
椞	椞
椥	椥
椪	椪
椯	椯
椰	椰
椱	椱
椲	□
椳	椳
椴	椴
椵	椵
椶	椶
椷	椷
椸	椸
椹	椹
椺	椺
椻	椻
椼	椼
椽	椽
椾	椾
椿	椿
楀	楀
楁	楁
楂	楂
楃	楃
楄	楄
楅	楅
楆	楆
楇	□
楈	楈
楉	楉
楊	杨
楋	楋
楌	楌
楍	楍
楎	□
楏	楏
楐	楐
楑	楑
楒	楒
楓	枫
楔	楔
楕	楕
楖	楖
楗	楗
楘	楘
楙	楙
楚	楚
楛	楛
楜	楜
楝	楝
楞	愣
楟	楟
楠	楠
楡	楡
楢	楢
楣	楣
楤	楤
楥	楥
楦	楦
楧	楧
楨	桢
楩	楩
楪	楪
楫	楫
楬	楬
業	业
楮	楮
楯	楯
楰	楰
楱	楱
楲	楲
楳	楳
楴	楴
極	极
楶	楶
楷	楷
楸	楸
楹	楹
楺	楺
楻	楻
楽	乐
榀	榀
概	概
榃	榃
榆	榆
榊	榊
榍	榍
榎	榎
榏	榏
榐	榐
榑	榑
榒	榒
榓	榓
榔	榔
榕	榕
榖	榖
榗	□
榘	榘
榙	榙
榚	榚
榛	榛
榜	榜
榞	榞
榟	榟
榠	榠
榡	榡
榢	榢
榣	□
榤	榤
榥	榥
榦	榦
榧	榧
榨	榨
榩	榩
榪	杩
榫	榫
榬	榬
榭	榭
榮	荣
榯	□
榰	榰
榱	榱
榲	榅
榳	榳
榴	榴
榵	榵
榶	榶
榷	榷
榸	榸
榹	榹
榺	榺
榻	榻
榼	榼
榽	榽
榾	榾
榿	桤
槀	槀
槁	槁
槂	□
槃	槃
槄	槄
槅	槅
槆	槆
槇	槇
槈	槈
槉	槉
槊	槊
構	构
槌	槌
槍	枪
槎	槎
槏	槏
槐	槐
槑	槑
槒	槒
槓	杠
槔	槔
槕	槕
槖	槖
様	样
槙	槙
槜	槜
槢	槢
槣	槣
槤	梿
槥	槥
槦	槦
槧	椠
槨	槨
槩	槩
槪	概
槫	□
槬	槬
槭	槭
槮	椮
槯	槯
槰	槰
槱	槱
槲	槲
槳	桨
槴	槴
槵	槵
槶	□
槷	槷
槸	槸
槹	槹
槺	槺
槻	□
槼	椝
槽	槽
槾	槾
槿	槿
樀	樀
樁	桩
樂	乐
樃	樃
樄	□
樅	枞
樆	樆
樇	樇
樈	樈
樉	樉
樊	樊
樋	樋
樌	□
樍	□
樎	樎
樏	樏
樐	□
樑	樑
樒	樒
樓	楼
樔	樔
樕	樕
樖	樖
樗	樗
樘	樘
標	标
樚	樚
樛	樛
樜	樜
樝	樝
樞	枢
樟	樟
樠	□
模	模
樢	□
樣	样
樤	□
樥	樥
樦	樦
樧	榝
樨	樨
権	权
樫	□
樬	樬
樲	□
樳	桪
樴	枳
樵	樵
樶	樶
樷	樷
樸	朴
樹	树
樺	桦
樻	□
樼	樼
樽	樽
樾	樾
樿	椫
橀	橀
橁	□
橂	橂
橃	□
橄	橄
橅	□
橆	橆
橇	橇
橈	桡
橉	橉
橊	橊
橋	桥
橌	□
橍	□
橎	橎
橏	橏
橐	橐
橑	橑
橒	枟
橓	橓
橔	橔
橕	□
橖	橖
橗	橗
橘	橘
橙	橙
橚	□
橛	橛
橜	橜
橝	橝
橞	橞
機	机
橠	橠
橡	橡
橢	椭
橣	橣
橤	橤
橦	橦
橧	橧
橨	□
橩	□
橪	橪
橫	横
橬	橬
橭	橭
橮	□
橯	□
橰	橰
橶	橶
橷	橷
橺	□
橽	□
橾	橾
橿	橿
檀	檀
檁	檩
檂	□
檃	□
檄	檄
檅	檅
檆	檆
檇	檇
檈	檈
檉	柽
檊	檊
檋	□
檌	檌
檍	檍
檎	檎
檏	□
檑	檑
檒	□
檓	檓
檔	档
檕	檕
檖	檖
檗	檗
檘	檘
檙	檙
檚	檚
檛	□
檜	桧
檝	檝
檞	檞
檟	槚
檠	檠
檡	□
檢	检
檣	樯
檤	檤
檥	□
檦	檦
檧	檧
檨	檨
檫	檫
檬	檬
檭	□
檮	梼
檯	台
檰	□
檱	檱
檳	槟
檴	檴
檵	檵
檶	□
檷	□
檸	柠
檹	檹
檺	檺
檻	槛
檼	□
檽	檽
檾	□
檿	檿
櫀	櫀
櫁	櫁
櫂	櫂
櫃	柜
櫄	櫄
櫅	□
櫆	櫆
櫇	□
櫈	櫈
櫉	橱
櫋	櫋
櫌	□
櫍	□
櫎	□
櫏	櫏
櫐	櫐
櫑	櫑
櫒	櫒
櫓	橹
櫔	□
櫕	□
櫖	□
櫗	櫗
櫘	櫘
櫙	□
櫚	榈
櫛	栉
櫜	櫜
櫝	椟
櫞	橼
櫟	栎
櫠	□
櫡	櫡
櫢	□
櫣	□
櫥	橱
櫧	槠
櫨	栌
櫩	□
櫪	枥
櫫	橥
櫬	榇
櫭	櫭
櫮	櫮
櫯	□
櫰	櫰
櫱	櫱
櫲	櫲
櫳	栊
櫴	□
櫶	□
櫸	榉
櫹	□
櫺	櫺
櫻	樱
櫼	櫼
櫽	□
櫾	櫾
櫿	□
欀	欀
欁	□
欂	欂
欃	欃
欄	栏
欅	□
欆	□
欇	欇
欈	欈
欉	□
權	权
欋	欋
欎	欎
欏	椤
欐	□
欑	□
欒	栾
欓	□
欔	欔
欖	榄
欘	□
欙	欙
欚	欚
欛	□
欜	欜
欝	欝
欞	棂
欠	欠
次	次
欣	欣
欥	欥
欦	欦
欨	欨
欩	欩
欪	欪
欫	欫
欬	欬
欭	欭
欮	欮
欯	欯
欰	欰
欱	欱
欲	欲
欳	欳
欴	欴
欵	欵
欶	欶
欷	欷
欸	欸
欹	欹
欺	欺
欻	欻
欼	欼
欽	钦
款	款
欿	欿
歀	歀
歁	歁
歂	歂
歃	歃
歅	歅
歆	歆
歇	歇
歈	歈
歉	歉
歊	歊
歋	歋
歌	歌
歍	□
歎	叹
歏	歏
歐	欧
歑	歑
歒	歒
歓	欢
歔	歔
歕	□
歖	歖
歗	□
歘	歘
歙	歙
歛	□
歜	歜
歝	□
歞	□
歟	欤
歠	歠
歡	欢
止	止
正	正
此	此
步	步
武	武
歧	歧
歨	歨
歩	歩
歪	歪
歫	歫
歬	歬
歭	歭
歮	歮
歯	齿
歰	歰
歱	歱
歲	岁
歳	岁
歴	歴
歵	□
歶	歶
歷	历
歸	归
歹	歹
歺	歺
死	死
歽	歽
歾	歾
歿	殁
殀	殀
殂	殂
殃	殃
殄	殄
殅	殅
殆	殆
殈	殈
殉	殉
殊	殊
殌	□
殍	殍
殎	□
殏	殏
殐	殐
殑	殑
殔	殔
殕	殕
殖	殖
殗	殗
殘	残
殙	殙
殛	殛
殜	殜
殞	殒
殟	殟
殠	殠
殢	殢
殣	殣
殤	殇
殥	殥
殦	□
殧	殧
殨	□
殩	殩
殪	殪
殫	殚
殬	□
殭	僵
殮	殓
殯	殡
殰	□
殲	歼
殳	殳
段	段
殶	殶
殷	殷
殸	殸
殹	殹
殺	杀
殻	壳
殼	壳
殽	殽
殾	殾
殿	殿
毀	毁
毃	毃
毄	□
毅	毅
毆	殴
毇	毇
毈	毈
毉	毉
毊	□
母	母
毎	每
每	每
毐	毐
毑	毑
毒	毒
毓	毓
比	比
毖	毖
毗	毗
毘	毘
毚	毚
毛	毛
毞	毞
毠	毠
毢	毢
毣	毣
毤	毤
毥	毥
毦	毦
毧	毧
毨	毨
毩	毩
毪	毪
毫	毫
毬	毬
毭	毭
毯	毯
毰	毰
毱	毱
毲	毲
毳	毳
毴	毴
毷	毷
毸	毸
毹	毹
毺	毺
毻	毻
毼	毼
毽	毽
毾	毾
毿	毵
氀	□
氁	氁
氂	牦
氃	氃
氄	氄
氅	氅
氆	氆
氈	毡
氉	氉
氊	毡
氋	氋
氌	氇
氍	氍
氎	氎
氐	氐
氒	氒
氓	氓
氕	氕
氖	氖
気	气
氘	氘
氙	氙
氚	氚
氛	氛
氜	氜
氝	氝
氟	氟
氠	氠
氡	氡
氣	气
氤	氤
氥	氥
氦	氦
氧	氧
氨	氨
氪	氪
氫	氢
氬	氩
氭	□
氮	氮
氯	氯
氰	氰
氱	□
氳	氲
水	水
氵	氵
氶	氶
氷	氷
永	永
氹	氹
氻	氻
氼	氼
氽	氽
氾	氾
氿	氿
汀	汀
汁	汁
求	求
汃	汃
汄	汄
汅	汅
汆	汆
汈	汈
汊	汊
汋	汋
汌	汌
汍	汍
汎	汎
汏	汏
汐	汐
汑	汑
汒	汒
汓	汓
汔	汔
汕	汕
汖	汖
汗	汗
汘	汘
汙	污
汚	污
汛	汛
汜	汜
汝	汝
汞	汞
江	江
池	池
污	污
汥	汥
汦	汦
汧	汧
汨	汨
汩	汩
汪	汪
汫	汫
汬	汬
汭	汭
汮	汮
汯	汯
汰	汰
汱	汱
汲	汲
汳	汳
汴	汴
汵	汵
汶	汶
汷	汷
汸	汸
決	决
汻	汻
汽	汽
汾	汾
汿	汿
沀	沀
沁	沁
沂	沂
沃	沃
沅	沅
沆	沆
沇	沇
沈	沈
沊	沊
沌	沌
沍	沍
沎	沎
沏	沏
沐	沐
沑	沑
沒	没
沓	沓
沔	沔
沕	沕
沖	冲
沗	沗
沘	沘
沙	沙
沚	沚
沛	沛
沜	沜
沝	沝
沞	沞
沠	沠
沢	泽
沣	沣
沫	沫
沬	沬
沭	沭
沮	沮
沯	沯
沰	沰
沱	沱
沲	沲
河	河
沴	沴
沶	沶
沷	沷
沸	沸
油	油
沺	沺
治	治
沼	沼
沽	沽
沾	沾
沿	沿
泀	泀
況	况
泂	泂
泃	泃
泄	泄
泅	泅
泆	泆
泇	泇
泈	泈
泉	泉
泊	泊
泋	泋
泌	泌
泍	泍
泎	泎
泏	泏
泐	泐
泑	泑
泒	泒
泓	泓
泔	泔
法	法
泖	泖
泗	泗
泘	泘
泙	泙
泚	泚
泛	泛
泜	泜
泝	泝
泟	泟
泠	泠
泡	泡
波	波
泣	泣
泤	泤
泥	泥
泦	泦
泧	泧
注	注
泩	泩
泫	泫
泬	泬
泭	泭
泮	泮
泯	泯
泰	泰
泱	泱
泲	泲
泳	泳
泴	泴
泵	泵
泿	泿
洀	洀
洂	洂
洃	洃
洄	洄
洅	洅
洆	洆
洇	洇
洈	洈
洉	洉
洊	洊
洋	洋
洌	洌
洎	洎
洏	洏
洐	洐
洑	洑
洓	洓
洔	洔
洕	洕
洖	洖
洗	洗
洘	洘
洙	洙
洚	洚
洛	洛
洝	洝
洞	洞
洟	洟
洠	洠
洡	洡
洢	洢
洣	洣
洤	洤
津	津
洦	洦
洧	洧
洨	洨
洩	洩
洪	洪
洫	洫
洬	洬
洭	洭
洮	洮
洯	洯
洰	洰
洱	洱
洲	洲
洳	洳
洴	洴
洵	洵
洶	汹
洷	洷
洸	洸
洹	洹
洺	洺
活	活
洽	洽
派	派
洿	洿
浀	浀
流	流
浂	浂
浄	净
浖	浖
浗	浗
浘	浘
浙	浙
浚	浚
浛	浛
浜	浜
浝	浝
浞	浞
浟	浟
浠	浠
浡	浡
浢	浢
浣	浣
浤	浤
浥	浥
浦	浦
浧	浧
浨	浨
浩	浩
浪	浪
浫	浫
浬	浬
浭	浭
浮	浮
浯	浯
浰	浰
浱	浱
浲	浲
浳	浳
浴	浴
浵	浵
浶	浶
海	海
浸	浸
浹	浃
浺	浺
浻	浻
浼	浼
浽	浽
浾	浾
浿	□
涀	□
涁	涁
涂	涂
涃	涃
涄	涄
涅	涅
涆	涆
涇	泾
消	消
涉	涉
涊	涊
涋	涋
涍	涍
涎	涎
涏	涏
涐	涐
涑	涑
涒	涒
涓	涓
涔	涔
涕	涕
涖	涖
涗	涚
涘	涘
涙	涙
涜	渎
涪	涪
涫	涫
涬	涬
涭	涭
涮	涮
涯	涯
涰	涰
涱	□
液	液
涳	涳
涴	涴
涵	涵
涶	涶
涷	□
涸	涸
涹	涹
涺	涺
涻	涻
涼	凉
涽	涽
涾	涾
涿	涿
淁	淁
淂	淂
淃	淃
淄	淄
淅	淅
淆	淆
淇	淇
淈	淈
淉	淉
淊	淊
淋	淋
淌	淌
淍	淍
淎	淎
淏	淏
淐	淐
淑	淑
淒	凄
淓	淓
淔	淔
淕	淕
淖	淖
淗	淗
淘	淘
淙	□
淚	泪
淛	淛
淜	淜
淝	淝
淞	淞
淟	淟
淠	淠
淡	淡
淢	淢
淣	淣
淤	淤
淥	渌
淦	淦
淧	淧
淨	净
淩	淩
淪	沦
淫	淫
淬	淬
淭	淭
淮	淮
淯	淯
淰	淰
深	深
淲	淲
淳	淳
淴	淴
淵	渊
淶	涞
混	混
淸	清
淹	淹
淺	浅
添	添
淼	淼
淽	淽
淾	淾
淿	淿
渀	渀
渁	渁
渂	渂
渃	渃
渄	渄
清	清
渆	渆
渇	渇
済	济
渉	涉
渒	渒
渕	渕
渘	渘
渙	涣
渚	渚
減	减
渜	渜
渝	渝
渞	渞
渟	渟
渠	渠
渡	渡
渢	沨
渣	渣
渤	渤
渥	渥
渦	涡
渧	渧
渨	渨
渪	渪
渫	渫
測	测
渭	渭
渮	渮
港	港
渰	渰
渱	渱
渲	渲
渳	渳
渴	渴
渵	渵
渶	渶
渷	渷
游	游
渹	渹
渺	渺
渻	渻
渼	渼
渽	渽
渾	浑
渿	渿
湀	湀
湁	湁
湂	湂
湃	湃
湄	湄
湅	湅
湆	湆
湇	湇
湈	湈
湉	湉
湊	凑
湋	□
湌	湌
湍	湍
湎	湎
湏	□
湐	湐
湑	湑
湒	湒
湓	湓
湔	湔
湕	湕
湖	湖
湗	湗
湘	湘
湙	湙
湚	湚
湛	湛
湜	湜
湝	湝
湞	浈
湟	湟
湠	湠
湡	湡
湢	湢
湣	湣
湤	湤
湥	湥
湦	湦
湧	涌
湨	湨
湩	湩
湫	湫
湬	湬
湮	湮
湯	汤
湰	湰
湱	湱
湲	湲
湳	湳
湴	湴
湵	湵
湶	湶
湷	湷
湸	湸
湹	湹
湺	湺
湻	湻
湼	湼
湽	湽
満	满
溆	溆
溈	沩
溉	溉
溌	泼
溍	□
溎	溎
溏	溏
源	源
溑	□
溒	溒
溓	溓
溔	溔
溕	溕
準	准
溗	溗
溘	溘
溙	溙
溚	溚
溛	溛
溜	溜
溝	沟
溞	溞
溟	溟
溠	溠
溡	□
溢	溢
溣	□
溤	□
溥	溥
溦	溦
溧	溧
溨	溨
溩	□
溪	溪
溫	温
溬	溬
溭	溭
溮	浉
溯	溯
溰	□
溱	溱
溲	溲
溳	涢
溴	溴
溵	溵
溶	溶
溷	溷
溸	溸
溹	溹
溺	溺
溻	溻
溼	湿
溽	溽
溾	溾
溿	溿
滀	滀
滁	滁
滂	滂
滃	滃
滄	沧
滅	灭
滆	滆
滇	滇
滈	滈
滉	滉
滊	□
滋	滋
滌	涤
滍	滍
滎	荥
滏	滏
滑	滑
滒	滒
滓	滓
滔	滔
滕	滕
滖	滖
滘	滘
滙	汇
滛	滛
滜	滜
滝	泷
滣	滣
滫	滫
滬	沪
滭	□
滮	滮
滯	滞
滰	滰
滱	滱
滲	渗
滳	滳
滴	滴
滵	滵
滶	滶
滷	卤
滸	浒
滹	滹
滺	滺
滻	浐
滼	滼
滽	滽
滾	滚
滿	满
漀	漀
漁	渔
漂	漂
漃	漃
漄	漄
漅	漅
漆	漆
漇	漇
漈	漈
漉	漉
漊	溇
漋	漋
漌	漌
漍	□
漎	漎
漏	漏
漐	□
漑	溉
漒	□
漓	漓
演	演
漕	漕
漖	漖
漗	漗
漘	漘
漙	□
漚	沤
漛	漛
漜	漜
漝	漝
漞	□
漟	漟
漠	漠
漡	□
漢	汉
漣	涟
漤	漤
漥	漥
漦	漦
漧	漧
漨	漨
漩	漩
漪	漪
漫	漫
漬	渍
漭	漭
漮	漮
漯	漯
漰	漰
漱	漱
漲	涨
漳	漳
漴	漴
漵	漵
漶	漶
漷	漷
漸	渐
漹	漹
漺	漺
漻	漻
漼	漼
漽	漽
漾	漾
漿	浆
潀	潀
潁	颍
潂	潂
潃	潃
潄	潄
潅	灌
潊	潊
潌	潌
潎	潎
潏	潏
潐	潐
潑	泼
潒	潒
潓	潓
潔	洁
潕	□
潖	潖
潗	潗
潘	潘
潙	沩
潚	□
潛	潜
潝	潝
潞	潞
潟	潟
潠	潠
潡	潡
潢	潢
潣	□
潤	润
潥	潥
潦	潦
潧	潧
潨	潨
潩	潩
潪	潪
潫	潫
潬	□
潭	潭
潮	潮
潯	浔
潰	溃
潲	潲
潳	潳
潵	潵
潶	潶
潷	滗
潸	潸
潹	潹
潺	潺
潻	潻
潼	潼
潽	潽
潾	潾
潿	涠
澀	涩
澁	澁
澂	澂
澃	□
澄	澄
澅	□
澆	浇
澇	涝
澈	澈
澉	澉
澊	澊
澋	澋
澌	澌
澍	澍
澎	澎
澏	澏
澐	沄
澑	澑
澒	□
澓	澓
澔	澔
澕	□
澖	□
澗	涧
澘	澘
澙	澙
澞	澞
澟	□
澠	渑
澡	澡
澢	□
澣	澣
澤	泽
澥	澥
澦	滪
澧	澧
澨	澨
澩	泶
澪	澪
澫	□
澬	□
澭	澭
澮	浍
澯	澯
澰	□
澱	淀
澲	□
澳	澳
澴	澴
澵	澵
澶	澶
澷	澷
澸	澸
澹	澹
澺	澺
澻	澻
澼	澼
澽	澽
澾	□
澿	澿
激	激
濁	浊
濂	濂
濃	浓
濄	□
濅	濅
濆	□
濇	□
濈	濈
濉	濉
濊	□
濋	濋
濌	濌
濍	濍
濎	濎
濐	濐
濓	濓
濔	沵
濕	湿
濖	濖
濗	濗
濘	泞
濙	□
濚	溁
濛	蒙
濜	浕
濝	濝
濞	濞
濟	济
濠	濠
濡	濡
濢	濢
濣	濣
濤	涛
濥	濥
濦	□
濧	□
濨	濨
濩	濩
濪	濪
濫	滥
濬	濬
濭	濭
濮	□
濯	濯
濰	潍
濱	滨
濲	濲
濳	潜
濴	□
濶	□
濷	□
濺	溅
濻	□
濼	泺
濽	□
濾	滤
濿	□
瀀	沋
瀁	瀁
瀂	□
瀃	□
瀄	□
瀅	滢
瀆	渎
瀇	□
瀈	□
瀉	泻
瀊	□
瀋	沈
瀋	渖
瀌	瀌
瀍	瀍
瀎	瀎
瀏	浏
瀐	瀐
瀑	瀑
瀒	□
瀓	瀓
瀕	濒
瀖	瀖
瀗	□
瀘	泸
瀙	□
瀚	瀚
瀛	瀛
瀜	瀜
瀝	沥
瀞	瀞
瀟	潇
瀠	潆
瀡	□
瀢	□
瀣	瀣
瀤	瀤
瀥	瀥
瀦	潴
瀧	泷
瀨	濑
瀩	□
瀪	瀪
瀫	瀫
瀬	□
瀯	□
瀰	弥
瀱	瀱
瀲	潋
瀳	瀳
瀴	□
瀵	瀵
瀶	□
瀷	瀷
瀸	瀸
瀹	瀹
瀺	瀺
瀻	瀻
瀼	瀼
瀽	瀽
瀾	澜
瀿	瀿
灀	灀
灁	□
灂	灂
灃	灃
灄	滠
灅	灅
灆	□
灇	□
灈	灈
灉	灉
灊	灊
灌	灌
灍	□
灎	滟
灑	洒
灒	□
灓	□
灔	滟
灕	□
灖	灖
灗	灗
灘	滩
灙	□
灚	□
灛	□
灝	灏
灞	灞
灟	□
灠	□
灡	□
灢	灢
灣	湾
灤	滦
灥	灥
灦	□
灧	滟
灩	灩
灪	□
火	火
灬	灬
灮	灮
灰	灰
灱	灱
灲	灲
灴	灴
灶	灶
灷	灷
灸	灸
灹	灹
灺	灺
灻	灻
灼	灼
災	灾
炁	炁
炂	炂
炃	炃
炄	炄
炅	炅
炆	炆
炇	炇
炈	炈
炊	炊
炋	炋
炌	炌
炍	炍
炎	炎
炏	炏
炐	炐
炑	炑
炒	炒
炓	炓
炔	炔
炕	炕
炗	炗
炘	炘
炙	炙
炛	炛
炟	炟
炠	炠
炡	炡
炢	炢
炣	炣
炤	炤
炥	炥
炦	炦
炧	炧
炨	炨
炩	炩
炪	炪
炫	炫
炬	炬
炭	炭
炮	炮
炯	炯
炰	炰
炱	炱
炲	炲
炳	炳
炴	炴
炵	炵
炶	炶
炷	炷
炸	炸
為	为
炻	炻
炾	炾
烀	烀
烄	烄
烅	烅
烆	烆
烇	烇
烈	烈
烉	烉
烊	烊
烋	烋
烌	烌
烍	烍
烎	烎
烏	乌
烐	烐
烑	烑
烒	烒
烓	烓
烔	烔
烕	烕
烖	烖
烗	烗
烘	烘
烙	烙
烚	烚
烜	烜
烝	烝
烞	烞
烠	烠
烡	烡
烢	烢
烣	烣
烤	烤
烯	烯
烰	烰
烱	烱
烲	烲
烳	烳
烴	烃
烵	烵
烶	烶
烷	烷
烸	烸
烹	烹
烺	烺
烻	烻
烼	烼
烽	烽
烾	烾
烿	烿
焀	焀
焂	焂
焃	焃
焄	焄
焅	焅
焆	焆
焇	焇
焈	焈
焉	焉
焊	焊
焋	□
焌	焌
焍	焍
焎	焎
焏	焏
焐	焐
焓	焓
焔	焰
焗	焗
焙	焙
焚	焚
焛	□
焜	焜
焝	焝
焞	焞
焟	焟
焠	焠
無	无
焢	焢
焣	焣
焤	焤
焥	焥
焦	焦
焧	焧
焨	焨
焩	焩
焪	焪
焫	焫
焬	焬
焭	□
焮	焮
焯	焯
焰	焰
焱	焱
焲	焲
焳	焳
焴	焴
焵	焵
然	然
焷	焷
焸	焸
焺	焺
焻	焻
焼	烧
煁	煁
煂	煂
煃	煃
煄	煄
煅	煅
煆	煆
煇	□
煈	□
煉	炼
煊	煊
煋	煋
煌	煌
煍	煍
煎	煎
煏	煏
煐	煐
煑	煑
煒	炜
煓	煓
煔	煔
煕	煕
煖	煖
煗	煗
煘	煘
煙	烟
煚	煚
煛	煛
煜	煜
煝	煝
煞	煞
煟	煟
煠	煠
煡	煡
煢	茕
煣	煣
煤	煤
煥	焕
煦	煦
照	照
煨	煨
煩	烦
煪	煪
煫	煫
煬	炀
煭	煭
煮	煮
煰	煰
煱	㶽
煲	煲
煳	煳
煵	煵
煸	煸
煹	煹
煺	煺
煻	煻
煼	煼
煽	煽
煾	煾
煿	煿
熀	熀
熁	熁
熂	□
熃	□
熄	熄
熅	煴
熆	熆
熇	熇
熈	熈
熉	□
熊	熊
熋	熋
熌	□
熎	熎
熏	熏
熐	熐
熑	熑
熒	荧
熓	熓
熔	熔
熗	炝
熘	熘
熙	熙
熚	□
熛	熛
熜	熜
熝	熝
熞	熞
熟	熟
熠	熠
熡	□
熢	熢
熣	熣
熤	熤
熥	熥
熦	熦
熧	□
熨	熨
熩	熩
熪	熪
熫	熫
熬	熬
熭	熭
熮	熮
熯	熯
熰	□
熱	热
熲	颎
熳	熳
熵	熵
熶	熶
熷	熷
熸	熸
熹	熹
熺	熺
熻	熻
熼	熼
熽	□
熾	炽
熿	熿
燀	□
燁	烨
燂	燂
燃	燃
燄	燄
燅	燅
燆	□
燇	燇
燈	灯
燉	炖
燊	燊
燋	燋
燌	□
燍	燍
燎	燎
燏	燏
燐	燐
燑	燑
燒	烧
燓	燓
燔	燔
燕	燕
燖	□
燗	□
燘	□
燙	烫
燚	燚
燛	燛
燜	焖
營	营
燠	□
燡	□
燢	□
燣	燷
燤	□
燥	燥
燦	灿
燧	燧
燨	□
燩	燩
燪	燪
燫	燫
燬	毀
燭	烛
燮	燮
燯	燯
燰	□
燱	燱
燲	□
燳	燳
燴	烩
燶	□
燸	燸
燹	燹
燺	燺
燻	燻
燼	烬
燽	燽
燾	焘
燿	燿
爀	爀
爁	□
爂	爂
爃	□
爄	□
爅	爅
爆	爆
爇	□
爈	□
爉	□
爊	爊
爋	爋
爌	□
爍	烁
爏	□
爐	炉
爑	爑
爒	爒
爓	□
爔	爔
爕	爕
爖	□
爗	爗
爙	爙
爚	爚
爛	烂
爜	□
爝	爝
爞	爞
爟	爟
爡	爡
爢	爢
爣	□
爤	□
爥	□
爧	□
爨	爨
爩	□
爪	爪
爫	爫
爬	爬
爭	争
爮	爮
爯	爯
爰	爰
爲	为
爴	爴
爵	爵
父	父
爸	爸
爹	爹
爺	爷
爻	爻
爼	爼
爽	爽
爾	尔
爿	爿
牀	床
牁	牁
牂	牂
牃	牃
牄	□
牅	牅
牆	墙
片	片
版	版
牉	牉
牊	牊
牋	□
牌	牌
牎	牎
牏	牏
牐	牐
牑	牑
牒	牒
牓	牓
牔	牔
牕	牕
牖	牖
牘	牍
牙	牙
牚	牚
牛	牛
牜	牜
牝	牝
牞	牞
牟	牟
牠	牠
牡	牡
牢	牢
牣	牣
牤	牤
牥	牥
牧	牧
牨	牨
物	物
牪	牪
牫	牫
牬	牬
牭	牭
牮	牮
牯	牯
牰	牰
牱	牱
牲	牲
牳	牳
牴	牴
牶	牶
牷	牷
牸	牸
特	特
牻	牻
牼	□
牽	牵
牾	牾
牿	牿
犀	犀
犁	犁
犂	犂
犃	犃
犄	犄
犅	□
犆	犆
犇	犇
犈	犈
犉	犉
犋	犋
犌	犌
犍	犍
犎	犎
犏	犏
犐	犐
犑	犑
犒	犒
犓	犓
犔	□
犕	犕
犖	荦
犗	犗
犘	犘
犙	□
犚	犚
犛	犛
犜	犜
犝	犝
犟	犟
犡	□
犢	犊
犣	犣
犤	□
犥	犥
犦	犦
犧	牺
犨	犨
犩	犩
犪	犪
犫	犫
犬	犬
犭	犭
犮	犮
犯	犯
犰	犰
犱	犱
犲	犲
犳	犳
犴	犴
犵	犵
犺	犺
犻	犻
犼	犼
犽	犽
犾	犾
犿	犿
狀	状
狁	狁
狂	狂
狃	狃
狄	狄
狅	狅
狆	狆
狇	狇
狉	狉
狊	狊
狋	狋
狌	狌
狍	狍
狎	狎
狏	狏
狐	狐
狑	狑
狒	狒
狓	狓
狔	狔
狕	狕
狖	狖
狗	狗
狘	狘
狙	狙
狚	狚
狛	狛
狜	狜
狟	狟
狠	狠
狡	狡
狢	狢
狣	狣
狤	狤
狥	狥
狦	狦
狧	狧
狨	狨
狩	狩
狪	狪
狫	狫
狳	狳
狴	狴
狵	狵
狶	狶
狷	狷
狸	狸
狹	狭
狺	狺
狻	狻
狼	狼
狽	狈
狾	狾
狿	狿
猀	猀
猁	猁
猂	猂
猄	猄
猅	猅
猆	猆
猇	猇
猈	猈
猉	猉
猊	猊
猋	猋
猌	□
猍	□
猏	猏
猐	猐
猑	猑
猒	猒
猓	猓
猔	猔
猖	猖
猗	猗
猘	猘
猙	狰
猚	猚
猛	猛
猜	猜
猝	猝
猞	猞
猢	猢
猣	猣
猤	猤
猥	猥
猦	□
猧	□
猨	猨
猩	猩
猭	猭
猯	猯
猰	猰
猱	猱
猲	猲
猳	猳
猴	猴
猵	猵
猶	犹
猷	猷
猸	猸
猹	猹
猺	□
猻	狲
猼	猼
猽	猽
猾	猾
猿	猿
獀	獀
獁	犸
獂	獂
獃	呆
獄	狱
獅	狮
獆	獆
獈	獈
獉	獉
獊	□
獋	獋
獌	獌
獍	獍
獎	奖
獐	獐
獑	□
獒	獒
獓	獓
獔	獔
獕	獕
獖	□
獗	獗
獘	獘
獙	獙
獚	獚
獛	獛
獜	獜
獝	獝
獞	獞
獟	□
獠	獠
獡	獡
獢	□
獥	獥
獦	獦
獧	獧
獨	独
獩	□
獪	狯
獫	猃
獬	獬
獮	狝
獯	獯
獰	狞
獱	□
獲	获
獳	獳
獴	獴
獵	猎
獶	□
獷	犷
獸	兽
獹	□
獺	獭
獻	献
獼	猕
獽	獽
獿	獿
玀	猡
玁	□
玂	□
玃	玃
玄	玄
玅	玅
玆	玆
率	率
玈	玈
玉	玉
玊	玊
王	王
玌	玌
玍	玍
玎	玎
玏	玏
玐	玐
玒	玒
玓	玓
玔	玔
玕	玕
玖	玖
玗	玗
玘	玘
玜	玜
玝	玝
玞	玞
玟	玟
玠	玠
玡	玡
玢	玢
玣	玣
玤	玤
玥	玥
玦	玦
玧	玧
玨	玨
玩	玩
玪	玪
玫	玫
玬	玬
玭	玭
玲	玲
玳	玳
玴	玴
玵	玵
玶	玶
玷	玷
玸	玸
玹	玹
玻	玻
玼	玼
玽	玽
玾	玾
玿	玿
珀	珀
珁	珁
珂	珂
珃	珃
珄	珄
珅	珅
珆	珆
珇	珇
珈	珈
珉	珉
珊	□
珋	珋
珌	珌
珍	珍
珎	珎
珏	珏
珒	珒
珓	珓
珔	珔
珕	珕
珖	珖
珗	珗
珘	珘
珙	珙
珚	珚
珛	珛
珜	珜
珝	珝
珞	珞
珟	珟
珠	珠
珡	珡
珢	珢
珣	珣
珤	珤
珥	珥
珦	珦
珧	珧
珨	珨
珩	珩
珪	珪
珫	珫
珬	珬
班	班
珮	珮
珳	珳
珴	珴
珵	珵
珶	珶
珷	珷
珸	珸
珹	珹
珺	珺
珻	珻
珼	□
珽	珽
現	现
珿	珿
琀	琀
琁	琁
琂	琂
球	球
琄	琄
理	理
琇	琇
琈	琈
琉	琉
琊	琊
琋	琋
琌	琌
琍	琍
琓	琓
琔	琔
琕	琕
琖	□
琗	琗
琘	琘
琙	琙
琚	琚
琛	琛
琜	□
琝	琝
琞	琞
琟	琟
琠	琠
琡	琡
琢	琢
琣	琣
琤	琤
琥	琥
琦	琦
琧	□
琨	琨
琩	琩
琪	琪
琫	琫
琬	琬
琭	琭
琮	琮
琯	琯
琰	琰
琱	琱
琲	琲
琳	琳
琴	琴
琵	琵
琶	琶
琷	琷
琸	琸
琹	琹
琺	珐
琽	琽
琾	琾
琿	珲
瑀	瑀
瑁	瑁
瑂	瑂
瑄	瑄
瑅	瑅
瑆	瑆
瑇	瑇
瑈	瑈
瑉	瑉
瑊	瑊
瑋	玮
瑌	瑌
瑍	□
瑎	瑎
瑏	瑏
瑐	瑐
瑑	瑑
瑒	玚
瑓	瑓
瑔	瑔
瑕	瑕
瑖	瑖
瑗	瑗
瑘	瑘
瑙	瑙
瑚	瑚
瑛	瑛
瑜	瑜
瑝	瑝
瑞	瑞
瑟	瑟
瑠	瑠
瑢	瑢
瑣	琐
瑤	瑶
瑥	瑥
瑦	□
瑧	瑧
瑨	瑨
瑩	莹
瑪	玛
瑫	瑫
瑬	瑬
瑭	瑭
瑮	瑮
瑯	琅
瑰	瑰
瑱	瑱
瑲	玱
瑳	瑳
瑴	瑴
瑵	瑵
瑹	瑹
瑺	瑺
瑻	□
瑼	□
瑽	□
瑾	瑾
瑿	瑿
璀	璀
璁	璁
璂	璂
璃	璃
璄	璄
璅	璅
璆	璆
璇	璇
璈	璈
璉	琏
璊	□
璋	璋
璌	璌
璏	璏
璐	璐
璑	□
璒	璒
璔	璔
璕	□
璖	璖
璗	□
璘	璘
璙	璙
璚	璚
璛	□
璜	璜
璝	□
璞	璞
璟	璟
璠	璠
璡	琎
璢	璢
璣	玑
璥	璥
璦	瑷
璧	璧
璨	璨
璩	璩
璪	璪
璫	珰
璬	璬
璭	□
璮	璮
璯	□
環	环
璱	璱
璲	璲
璳	□
璵	玙
璶	□
璷	璷
璸	瑸
璹	□
璺	□
璻	璻
璼	□
璽	玺
璾	□
璿	璿
瓀	瓀
瓁	瓁
瓂	□
瓃	瓃
瓄	□
瓅	□
瓆	□
瓇	□
瓈	瓈
瓉	□
瓊	琼
瓋	□
瓌	瓌
瓍	□
瓎	□
瓏	珑
瓐	□
瓑	□
瓓	□
瓔	璎
瓕	□
瓖	瓖
瓗	瓗
瓘	瓘
瓙	□
瓚	瓒
瓛	瓛
瓜	瓜
瓝	瓝
瓞	瓞
瓟	瓟
瓠	瓠
瓡	瓡
瓢	瓢
瓣	瓣
瓤	瓤
瓥	瓥
瓨	瓨
瓪	瓪
瓫	瓫
瓬	瓬
瓭	瓭
瓮	瓮
瓳	瓳
瓴	瓴
瓵	瓵
瓶	瓶
瓷	瓷
瓹	瓹
瓺	瓺
瓻	瓻
瓽	瓽
瓾	瓾
瓿	瓿
甀	甀
甁	瓶
甂	甂
甃	甃
甄	甄
甆	甆
甇	□
甈	甈
甉	甉
甊	□
甋	甋
甌	瓯
甍	甍
甎	□
甏	甏
甐	甐
甑	甑
甒	□
甓	甓
甔	甔
甕	甕
甖	□
甗	甗
甘	甘
甙	甙
甚	甚
甛	甛
甜	甜
甝	甝
甞	甞
生	生
甠	甠
甡	甡
產	产
産	产
甤	甤
甥	甥
甦	甦
甧	甧
用	用
甩	甩
甪	甪
甫	甫
甬	甬
甭	甭
甮	甮
甯	宁
田	田
由	由
甲	甲
申	申
甴	甴
甶	甶
男	男
甸	甸
甹	甹
町	町
甼	甼
甽	甽
甾	甾
甿	甿
畀	畀
畁	畁
畂	畂
畃	畃
畄	留
畆	畆
畇	畇
畈	畈
畉	畉
畊	畊
畋	畋
界	界
畍	畍
畎	畎
畏	畏
畐	畐
畑	畑
畒	畒
畔	畔
畕	畕
畖	畖
畗	畗
畘	畘
留	留
畚	畚
畛	畛
畜	畜
畝	亩
畞	畞
畟	畟
畡	畡
畢	毕
畣	畣
畤	畤
略	略
畦	畦
畧	畧
畨	畨
番	番
畫	画
畬	畬
畭	畭
畮	畮
畯	畯
異	异
畱	畱
畲	畲
畳	畳
畵	画
當	当
畷	畷
畸	畸
畹	畹
畺	畺
畻	畻
畼	□
畽	畽
畾	畾
畿	畿
疀	疀
疁	疁
疃	疃
疄	疄
疅	疅
疆	疆
疇	畴
疈	疈
疉	疉
疊	叠
疋	疋
疌	疌
疍	疍
疎	疎
疏	疏
疐	疐
疑	疑
疒	疒
疓	疓
疔	疔
疕	疕
疘	疘
疙	疙
疚	疚
疛	疛
疜	疜
疝	疝
疞	疞
疢	疢
疣	疣
疤	疤
疥	疥
疦	疦
疧	疧
疨	疨
疩	疩
疪	疪
疫	疫
疰	疰
疱	疱
疲	疲
疳	疳
疴	疴
疵	疵
疶	疶
疷	疷
疸	疸
疹	疹
疺	疺
疻	疻
疼	疼
疽	疽
疾	疾
疿	疿
痀	痀
痁	痁
痂	痂
痃	痃
痄	痄
病	病
痆	痆
症	症
痊	痊
痋	痋
痌	痌
痍	痍
痎	痎
痏	痏
痐	痐
痑	痑
痓	痓
痔	痔
痕	痕
痗	痗
痘	痘
痙	痉
痚	痚
痛	痛
痜	痜
痝	痝
痞	痞
痟	痟
痠	痠
痡	痡
痢	痢
痣	痣
痤	痤
痥	痥
痦	痦
痧	痧
痩	痩
痬	痬
痭	痭
痮	□
痯	痯
痰	痰
痱	痱
痲	麻
痳	痳
痵	痵
痶	痶
痷	痷
痸	痸
痹	痹
痺	痺
痻	痻
痼	痼
痽	痽
痾	痾
痿	痿
瘀	瘀
瘁	瘁
瘂	痖
瘃	瘃
瘄	瘄
瘇	瘇
瘈	瘈
瘉	瘉
瘊	瘊
瘋	疯
瘌	瘌
瘍	疡
瘎	瘎
瘏	瘏
瘐	瘐
瘑	□
瘒	□
瘓	痪
瘔	瘔
瘕	瘕
瘖	瘖
瘙	瘙
瘚	瘚
瘛	瘛
瘜	瘜
瘝	瘝
瘞	瘞
瘟	瘟
瘠	瘠
瘡	疮
瘢	瘢
瘣	瘣
瘤	瘤
瘥	瘥
瘦	瘦
瘧	疟
瘨	瘨
瘩	瘩
瘬	□
瘭	瘭
瘮	瘆
瘯	瘯
瘰	瘰
瘱	瘗
瘲	疭
瘳	瘳
瘴	瘴
瘵	瘵
瘶	瘶
瘷	瘷
瘸	瘸
瘹	□
瘺	瘺
瘻	瘘
瘼	瘼
瘽	瘽
癀	癀
癁	癁
療	疗
癃	癃
癄	癄
癅	癅
癆	痨
癇	痫
癈	□
癉	瘅
癊	癊
癋	□
癌	癌
癍	癍
癎	□
癏	癏
癐	□
癑	□
癒	愈
癓	癓
癔	癔
癕	癕
癖	癖
癗	癗
癘	疠
癙	癙
癚	癚
癛	癝
癜	癜
癟	瘪
癠	□
癡	痴
癢	痒
癤	疖
癥	癥
癧	疬
癨	癨
癩	癞
癬	癣
癭	瘿
癮	瘾
癯	癯
癰	痈
癱	瘫
癲	癫
癳	癳
癴	□
癵	□
癸	癸
癹	癹
発	发
登	登
發	发
白	白
百	百
癿	癿
皀	皀
皁	皁
皂	皂
皃	皃
的	的
皅	皅
皆	皆
皇	皇
皈	皈
皉	皉
皊	皊
皋	皋
皌	皌
皍	皍
皎	皎
皏	皏
皐	皐
皒	皒
皓	皓
皔	皔
皕	皕
皖	皖
皗	皗
皘	皘
皙	皙
皚	皑
皛	皛
皜	皜
皝	皝
皞	皞
皟	□
皠	皠
皡	皡
皢	皢
皣	□
皤	皤
皥	皥
皦	皦
皧	□
皨	皨
皩	皩
皪	□
皫	皫
皬	皬
皭	皭
皮	皮
皯	皯
皰	皰
皳	皳
皴	皴
皵	皵
皶	皶
皷	皷
皸	皲
皹	皲
皺	皱
皻	皻
皼	皼
皽	皽
皾	□
皿	皿
盀	盀
盁	盁
盂	盂
盃	杯
盄	盄
盅	盅
盆	盆
盇	盇
盈	盈
盉	盉
益	益
盋	盋
盌	盌
盍	盍
盎	盎
盒	盒
盓	盓
盔	盔
盕	盕
盙	盙
盚	盚
盛	盛
盜	盗
盝	盝
盞	盏
盟	盟
盠	盠
盡	尽
盢	盢
監	监
盤	盘
盥	盥
盦	盦
盧	卢
盨	□
盩	盩
盪	荡
盫	盫
盬	盬
盭	盭
目	目
盯	盯
盰	盰
盱	盱
盲	盲
盳	盳
直	直
盵	盵
盶	盶
盷	盷
相	相
盹	盹
盺	盺
盻	盻
盼	盼
盽	盽
盾	盾
盿	盿
眀	眀
省	省
眂	眂
眃	眃
眄	眄
眅	眅
眆	眆
眇	眇
眈	眈
眉	眉
眊	眊
看	看
県	県
眎	眎
眏	眏
眐	眐
眑	眑
眒	眒
眓	眓
眔	眔
眕	眕
眖	眖
眗	眗
眘	眘
眙	眙
眚	眚
眛	眛
眜	眜
眝	眝
眞	眞
真	真
眠	眠
眡	眡
眢	眢
眣	眣
眤	眤
眥	眥
眦	眦
眧	眧
眨	眨
眩	眩
眪	眪
眫	眫
眭	眭
眮	眮
眰	眰
眱	眱
眲	眲
眳	眳
眴	眴
眵	眵
眶	眶
眷	眷
眸	眸
眹	眹
眺	眺
眻	眻
眼	眼
眽	眽
眾	众
眿	眿
睂	睂
睃	睃
睄	睄
睅	睅
睆	睆
睇	睇
睈	睈
睉	睉
睊	睊
睋	睋
睌	睌
睍	睍
睎	睎
睏	困
睒	睒
睓	睓
睔	□
睕	睕
睖	睖
睗	睗
睘	睘
睙	睙
睚	睚
睛	睛
睜	睁
睞	睐
睟	睟
睠	睠
睡	睡
睢	睢
督	督
睤	睤
睥	睥
睦	睦
睧	睧
睨	睨
睩	睩
睪	睪
睫	睫
睬	睬
睭	睭
睮	睮
睯	睯
睰	睰
睱	睱
睲	睲
睳	睳
睴	□
睶	睶
睷	睷
睸	睸
睹	睹
睺	睺
睻	睻
睼	睼
睽	睽
睾	睾
睿	睿
瞀	瞀
瞁	瞁
瞂	瞂
瞃	瞃
瞄	瞄
瞅	瞅
瞇	眯
瞈	瞈
瞉	瞉
瞊	瞊
瞋	瞋
瞌	瞌
瞍	瞍
瞎	瞎
瞏	瞏
瞐	瞐
瞑	瞑
瞓	□
瞔	瞔
瞕	瞕
瞖	瞖
瞗	□
瞘	眍
瞙	瞙
瞚	瞚
瞛	□
瞜	□
瞝	瞝
瞞	瞒
瞟	瞟
瞠	瞠
瞡	□
瞢	瞢
瞤	□
瞥	瞥
瞦	瞦
瞧	瞧
瞨	瞨
瞪	瞪
瞫	瞫
瞬	瞬
瞭	了
瞮	瞮
瞯	□
瞰	瞰
瞱	□
瞲	瞲
瞳	瞳
瞴	□
瞵	瞵
瞶	瞆
瞷	□
瞸	瞸
瞹	□
瞺	□
瞻	瞻
瞼	睑
瞽	瞽
瞾	瞾
瞿	瞿
矀	矀
矁	矁
矂	矂
矃	□
矄	矄
矅	矅
矆	矆
矇	蒙
矈	矈
矉	□
矊	□
矋	□
矌	□
矍	矍
矎	矎
矏	矏
矐	矐
矑	□
矒	矒
矓	眬
矔	矔
矕	□
矖	□
矗	矗
矘	□
矙	□
矚	瞩
矛	矛
矜	矜
矝	矝
矞	矞
矟	矟
矠	矠
矡	矡
矢	矢
矣	矣
矤	矤
知	知
矦	矦
矧	矧
矨	矨
矩	矩
矪	矪
矬	矬
短	短
矮	矮
矯	矫
矰	矰
矱	矱
矲	□
石	石
矴	矴
矵	矵
矷	矷
矸	矸
矹	矹
矺	矺
矻	矻
矼	矼
矽	矽
矾	矾
砂	砂
砃	砃
砄	砄
砅	砅
砆	砆
砇	砇
砈	砈
砉	砉
砊	砊
砋	砋
砌	砌
砍	砍
砎	砎
砏	砏
砐	砐
砑	砑
砒	砒
砓	砓
研	研
砕	砕
砘	砘
砙	砙
砝	砝
砞	砞
砟	砟
砠	砠
砡	砡
砢	砢
砣	砣
砤	砤
砥	砥
砦	砦
砧	砧
砨	砨
砩	砩
砪	砪
砫	砫
砬	砬
砭	砭
砮	砮
砯	砯
砰	砰
砱	砱
砲	砲
砳	砳
破	破
砵	砵
砶	砶
砷	砷
砸	砸
砹	砹
砼	砼
硂	硂
硃	硃
硄	硄
硅	硅
硆	硆
硇	硇
硈	硈
硉	硉
硊	硊
硋	硋
硌	硌
硍	硍
硎	硎
硏	硏
硐	硐
硑	硑
硒	硒
硔	硔
硜	硁
硝	硝
硞	硞
硟	硟
硠	硠
硡	硡
硢	硢
硣	硣
硤	硖
硥	硥
硦	硦
硧	硧
硨	砗
硩	硩
硪	硪
硫	硫
硬	硬
硭	硭
硯	砚
硰	硰
硱	硱
硲	硲
硶	硶
硸	硸
硹	硹
硺	硺
硻	□
硼	硼
硽	硽
硾	硾
硿	硿
碀	□
碁	棋
碂	碂
碃	碃
碄	碄
碅	碅
碆	碆
碇	碇
碈	碈
碉	碉
碊	□
碋	碋
碌	碌
碎	碎
碏	碏
碐	碐
碑	碑
碒	碒
碓	碓
碔	碔
碕	碕
碖	□
碗	碗
碘	碘
碙	□
碚	碚
碝	碝
碞	碞
碟	碟
碠	碠
碡	碡
碢	□
碣	碣
碤	碤
碥	碥
碦	碦
碧	碧
碨	碨
碩	硕
碪	碪
碫	碫
碬	碬
碭	砀
碮	碮
碯	□
碰	碰
碱	碱
碲	碲
碳	碳
碴	碴
碶	碶
碸	砜
碹	碹
確	确
碻	碻
碼	码
碽	□
碾	碾
碿	碿
磀	磀
磁	磁
磂	磂
磃	磃
磄	磄
磅	磅
磆	磆
磇	磇
磈	磈
磉	磉
磊	磊
磋	磋
磌	磌
磍	磍
磎	磎
磏	磏
磐	磐
磑	硙
磒	□
磓	磓
磔	磔
磕	磕
磖	磖
磘	磘
磙	磙
磚	砖
磛	□
磜	磜
磝	磝
磞	磞
磟	磟
磠	硵
磡	磡
磢	磢
磣	碜
磤	磤
磥	磥
磦	磦
磧	碛
磨	磨
磩	磩
磪	磪
磫	□
磬	磬
磭	磭
磯	矶
磰	磰
磱	□
磲	磲
磳	磳
磴	磴
磵	□
磶	磶
磷	磷
磸	磸
磹	磹
磺	磺
磻	磻
磼	磼
磽	硗
磾	□
磿	磿
礁	礁
礃	礃
礄	硚
礅	礅
礆	硷
礇	礇
礈	礈
礉	礉
礊	礊
礋	□
礌	礌
礍	礍
礎	础
礏	□
礐	□
礑	□
礒	□
礓	礓
礔	礔
礕	礕
礖	□
礗	□
礘	□
礙	碍
礚	□
礛	□
礜	□
礝	礝
礞	礞
礟	炮
礠	礠
礡	礡
礣	礣
礤	礤
礥	□
礦	矿
礧	礧
礨	礨
礩	□
礪	砺
礫	砾
礬	礬
礭	礭
礮	砲
礯	□
礰	□
礱	砻
礲	□
礳	礳
礴	礴
礵	礵
礶	礶
礷	□
礸	□
礹	□
示	示
礻	礻
礽	礽
社	社
礿	礿
祀	祀
祁	祁
祂	祂
祄	祄
祅	祅
祆	祆
祇	祇
祈	祈
祉	祉
祊	祊
祋	祋
祌	祌
祏	祏
祐	祐
祑	祑
祒	祒
祓	祓
祔	祔
祕	祕
祖	祖
祗	祗
祘	祘
祙	祙
祚	祚
祛	祛
祜	祜
祝	祝
神	神
祟	祟
祠	祠
祡	祡
祣	祣
祤	祤
祥	祥
祦	祦
祧	祧
票	票
祩	祩
祪	祪
祫	祫
祬	祬
祭	祭
祮	祮
祰	祰
祱	祱
祲	祲
祳	祳
祴	祴
祵	祵
祶	祶
祹	祹
祺	祺
祻	祻
祼	祼
祽	祽
祾	祾
祿	禄
禁	禁
禂	禂
禃	禃
禆	禆
禇	禇
禈	□
禉	禉
禊	禊
禋	禋
禌	禌
禍	祸
禎	祯
福	福
禐	禐
禑	禑
禒	禒
禓	□
禔	禔
禕	祎
禖	禖
禗	禗
禘	禘
禚	禚
禛	禛
禜	□
禝	禝
禞	禞
禟	禟
禠	禠
禡	祃
禢	禢
禤	禤
禥	禥
禦	御
禧	禧
禨	□
禩	禩
禪	禅
禫	禫
禬	□
禭	禭
禮	礼
禯	□
禰	祢
禱	祷
禲	□
禳	禳
禴	禴
禵	□
禶	□
禷	□
禸	禸
禹	禹
禺	禺
禼	禼
禽	禽
禾	禾
禿	秃
秀	秀
私	私
秂	秂
秄	秄
秅	秅
秆	秆
秇	秇
秈	秈
秉	秉
秊	秊
秋	秋
秌	秌
秎	秎
秏	秏
秐	秐
科	科
秒	秒
秓	秓
秔	秔
秕	秕
秖	秖
秗	秗
秘	秘
秙	秙
秚	秚
秛	秛
秜	秜
秝	秝
秞	秞
租	租
秠	秠
秡	秡
秢	秢
秣	秣
秤	秤
秥	秥
秦	秦
秧	秧
秨	秨
秩	秩
秪	秪
秫	秫
秬	秬
秭	秭
秮	秮
秱	秱
秲	秲
秳	秳
秴	秴
秵	秵
秶	秶
秷	秷
秸	秸
秹	秹
秺	秺
移	移
秼	秼
秿	秿
稀	稀
稁	稁
稂	稂
稃	稃
稄	稄
稅	税
稆	稆
稇	稇
稈	稈
稉	稉
稊	稊
程	程
稌	稌
稍	稍
稏	□
稐	□
稑	稑
稒	稒
稓	稓
稔	稔
稕	稕
稖	稖
稗	稗
稘	稘
稙	稙
稚	稚
稛	稛
稜	棱
稝	稝
稞	稞
稟	禀
稠	稠
稡	稡
稢	稢
稤	稤
稦	□
稧	稧
稨	稨
稩	稩
稪	稪
稫	稫
稬	稬
稭	稭
種	种
稯	稯
稰	稰
稱	称
稲	稻
稴	稴
稵	稵
稶	稶
稷	稷
稸	稸
稹	稹
稺	稺
稻	稻
稼	稼
稽	稽
稾	稾
稿	稿
穀	谷
穁	穁
穂	穗
穄	穄
穅	穅
穆	穆
穇	䅟
穈	穈
穉	穉
穊	穊
穋	穋
穌	稣
積	积
穎	颖
穏	稳
穐	穐
穓	穓
穔	穔
穕	穕
穖	□
穗	穗
穘	□
穙	穙
穚	□
穛	穛
穜	穜
穟	穟
穠	秾
穡	穑
穢	秽
穣	穣
穤	穤
穥	□
穧	□
穨	□
穩	稳
穪	□
穫	获
穬	□
穭	穞
穮	穮
穰	穰
穱	穱
穲	□
穳	□
穴	穴
穵	穵
究	究
穸	穸
穹	穹
空	空
穻	穻
穼	穼
穽	穽
穾	穾
穿	穿
窀	窀
突	突
窂	窂
窄	窄
窅	窅
窆	窆
窇	窇
窈	窈
窉	窉
窊	窊
窋	窋
窌	窌
窏	窏
窐	窐
窒	窒
窓	窓
窔	窔
窕	窕
窖	窖
窗	窗
窘	窘
窙	窙
窚	窚
窛	窛
窞	窞
窟	窟
窠	窠
窡	窡
窢	窢
窣	窣
窨	窨
窩	窝
窪	洼
窫	窫
窬	窬
窮	穷
窯	窑
窰	窑
窱	窱
窲	窲
窳	窳
窴	窴
窵	窎
窶	窭
窷	窷
窸	窸
窹	窹
窺	窥
窻	窻
窼	窼
窾	窾
窿	窿
竀	□
竁	竁
竂	竂
竄	窜
竅	窍
竆	竆
竇	窦
竈	灶
竉	□
竊	窃
立	立
竌	竌
竎	竎
竐	竐
竑	竑
竒	竒
竗	竗
竘	竘
站	站
竚	竚
竛	竛
竜	龙
竝	竝
竟	竟
章	章
竢	竢
竣	竣
竤	竤
童	童
竦	竦
竧	竧
竨	竨
竩	竩
竪	竖
竫	□
竬	竬
竭	竭
竮	竮
端	端
竰	竰
竱	□
竲	竲
竳	竳
竴	竴
竵	竵
競	竞
竸	竸
竹	竹
竺	竺
竻	竻
竼	竼
竽	竽
竾	竾
竿	竿
笀	笀
笁	笁
笄	笄
笅	笅
笆	笆
笇	笇
笈	笈
笉	笉
笊	笊
笌	笌
笍	笍
笎	笎
笏	笏
笐	笐
笑	笑
笒	笒
笓	笓
笖	笖
笗	笗
笘	笘
笙	笙
笚	笚
笛	笛
笜	笜
笝	笝
笞	笞
笟	笟
笠	笠
笡	笡
笢	笢
笣	笣
笤	笤
笥	笥
符	符
笧	笧
笨	笨
笩	笩
笪	笪
笫	笫
第	第
笭	笭
笮	笮
笯	笯
笰	笰
笱	笱
笲	笲
笳	笳
笴	笴
笵	笵
笶	笶
笷	笷
笸	笸
笻	笻
笿	笿
筀	筀
筁	筁
筂	筂
筃	筃
筄	筄
筅	筅
筆	笔
筇	筇
筈	筈
等	等
筊	筊
筋	筋
筌	筌
筍	笋
筎	筎
筏	筏
筐	筐
筒	筒
筓	筓
答	答
筕	筕
策	策
筗	筗
筘	筘
筙	筙
筞	筞
筟	筟
筠	筠
筡	筡
筢	筢
筣	筣
筤	筤
筥	筥
筦	筦
筧	笕
筨	筨
筩	筩
筪	筪
筫	□
筬	筬
筭	筭
筮	筮
筯	筯
筰	筰
筱	筱
筲	筲
筳	筳
筴	□
筵	筵
筶	筶
筷	筷
筸	筸
筻	筻
箁	箁
箂	□
箃	箃
箄	箄
箅	箅
箆	箆
箇	箇
箈	箈
箉	箉
箊	箊
箋	笺
箌	箌
箍	箍
箎	箎
箏	筝
箐	箐
箑	箑
箒	箒
箔	箔
箕	箕
箖	箖
算	算
箘	箘
箙	箙
箚	箚
箛	箛
箜	箜
箝	箝
箞	箞
箟	箟
箠	箠
管	管
箢	箢
箣	箣
箤	箤
箥	箥
箬	箬
箭	箭
箯	箯
箰	箰
箱	箱
箲	箲
箳	箳
箴	箴
箵	箵
箶	箶
箷	箷
箸	箸
箹	□
箺	箺
箻	箻
箼	箼
箽	箽
箾	箾
箿	箿
節	节
篁	篁
篂	篂
篃	篃
範	范
篅	篅
篆	篆
篇	篇
篈	篈
築	筑
篊	篊
篋	箧
篌	篌
篍	篍
篎	篎
篏	篏
篔	筼
篕	篕
篖	篖
篗	篗
篘	篘
篙	篙
篚	篚
篛	篛
篜	篜
篝	篝
篞	篞
篟	篟
篠	筿
篡	篡
篢	□
篣	篣
篤	笃
篥	篥
篦	篦
篧	篧
篨	篨
篩	筛
篪	篪
篫	篫
篬	□
篭	笼
篰	篰
篲	篲
篳	筚
篴	篴
篵	□
篶	篶
篷	篷
篸	□
篹	篹
篺	篺
篻	篻
篼	篼
篽	篽
篾	篾
篿	□
簀	箦
簁	簁
簂	□
簃	簃
簄	簄
簅	簅
簆	簆
簇	簇
簈	簈
簉	簉
簊	簊
簋	簋
簌	簌
簍	篓
簎	簎
簏	簏
簐	□
簑	簑
簒	簒
簔	簔
簕	簕
簘	箫
簙	簙
簚	簚
簛	簛
簜	□
簝	簝
簞	箪
簟	簟
簠	簠
簡	简
簢	□
簣	篑
簤	□
簥	□
簦	簦
簧	簧
簨	簨
簩	□
簪	簮
簫	箫
簬	簬
簭	簭
簮	簮
簰	簰
簲	簲
簳	簳
簴	簴
簵	□
簶	簶
簷	檐
簸	簸
簹	筜
簺	簺
簻	□
簼	簼
簽	签
簾	帘
簿	簿
籀	籀
籃	篮
籄	□
籅	籅
籆	籆
籇	籇
籈	籈
籉	□
籊	籊
籋	□
籌	筹
籍	籍
籐	籐
籑	籑
籒	籒
籓	籓
籔	䉤
籕	籕
籗	籗
籘	籘
籙	箓
籚	□
籛	篯
籜	箨
籝	籝
籞	籞
籟	籁
籠	笼
籢	□
籣	□
籤	签
籥	籥
籦	籦
籧	籧
籨	□
籩	笾
籪	簖
籫	□
籬	篱
籭	□
籮	箩
籯	籯
籰	籰
籱	籱
籲	吁
米	米
籵	籵
籶	籶
籷	籷
籸	籸
籹	籹
籺	籺
籼	籼
籽	籽
籾	籾
籿	籿
粁	粁
粃	粃
粄	粄
粅	粅
粆	粆
粇	粇
粈	粈
粉	粉
粊	粊
粋	粋
粍	粍
粎	粎
粑	粑
粒	粒
粓	粓
粔	粔
粕	粕
粖	粖
粗	粗
粘	粘
粙	粙
粚	粚
粛	肃
粜	粜
粞	粞
粟	粟
粠	粠
粡	粡
粢	粢
粣	□
粥	粥
粦	粦
粨	粨
粯	□
粰	粰
粱	粱
粲	粲
粳	粳
粴	粴
粵	粤
粶	粶
粷	粷
粸	粸
粹	粹
粺	粺
粻	□
粼	粼
粽	粽
精	精
粿	粿
糂	糂
糃	□
糄	糄
糅	糅
糆	糆
糇	糇
糈	糈
糉	粽
糊	糊
糋	糋
糌	糌
糍	糍
糎	糎
糏	糏
糐	糐
糑	糑
糒	糒
糓	糓
糔	糔
糕	糕
糖	糖
糗	糗
糙	糙
糚	粧
糛	糛
糜	糜
糝	糁
糞	粪
糟	糟
糠	糠
糡	糡
糢	糢
糣	糣
糤	糤
糥	糥
糦	糦
糧	粮
糨	糨
糩	□
糪	糪
糫	糫
糮	□
糯	糯
糰	团
糱	糱
糲	粝
糳	糳
糴	籴
糵	糵
糶	糶
糷	□
糸	糸
糺	□
系	系
糼	□
糽	□
糾	纠
糿	□
紀	纪
紁	□
紂	纣
紃	□
約	约
紅	红
紆	纡
紇	纥
紈	纨
紉	纫
紊	紊
紋	纹
紌	□
納	纳
紎	□
紏	□
紐	纽
紑	□
紒	□
紓	纾
純	纯
紕	纰
紖	纼
紗	纱
紘	纮
紙	纸
級	级
紛	纷
紜	纭
紝	纴
紞	□
紟	□
素	素
紡	纺
索	索
紣	□
紤	□
紥	紥
紨	□
紩	□
紪	□
紫	紫
紬	□
紭	□
紮	扎
累	累
細	细
紱	绂
紲	绁
紳	绅
紴	□
紵	纻
紶	□
紷	□
紸	□
紹	绍
紺	绀
紻	□
紼	绋
紽	□
紾	□
紿	绐
絀	绌
絁	□
終	终
絃	□
組	组
絅	□
絆	绊
絇	□
絈	□
絉	□
絊	□
経	经
絍	□
絎	绗
絏	□
結	结
絑	□
絒	□
絓	□
絔	□
絕	绝
絖	□
絗	□
絘	□
絙	□
絚	□
絛	絛
絜	絜
絝	绔
絞	绞
絟	□
絠	□
絡	络
絢	绚
絣	□
絤	□
絥	□
給	给
絧	□
絨	绒
絩	□
絪	□
絫	絫
絬	□
絭	絭
絮	絮
絯	□
絰	绖
統	统
絲	丝
絳	绛
絴	□
絵	绘
絶	绝
絸	□
絹	绢
絺	□
絻	□
絼	□
絽	□
絾	□
絿	□
綀	□
綁	绑
綂	□
綃	绡
綄	□
綅	□
綆	绠
綇	□
綈	绨
綉	□
綊	□
綋	□
綌	绤
綍	□
綎	□
綏	绥
綐	□
綑	□
綒	□
經	经
綔	綔
綕	□
綖	□
綗	□
綘	□
綜	综
綝	□
綞	缍
綟	□
綠	绿
綡	□
綢	绸
綣	绻
綤	綤
綥	□
綦	綦
綧	□
綨	□
綩	□
綪	□
綫	线
綬	绶
維	维
綮	綮
綯	绹
綰	绾
綱	纲
網	网
綳	绷
綴	缀
綵	采
綶	□
綷	□
綸	纶
綹	绺
綺	绮
綻	绽
綼	□
綽	绰
綾	绫
綿	绵
緀	□
緁	□
緂	□
緃	□
緄	绲
緅	□
緆	□
緇	缁
緈	□
緉	□
緊	紧
緋	绯
緌	□
緍	□
緎	□
総	总
緐	緐
緑	绿
緒	绪
緓	绬
緔	绱
緖	绪
緗	缃
緘	缄
緙	缂
線	线
線	缐
緛	□
緜	緜
緝	缉
緞	缎
緟	□
締	缔
緡	缗
緢	□
緣	缘
緤	□
緥	□
緦	缌
緧	□
編	编
緩	缓
緪	□
緫	□
緬	缅
緭	□
緮	□
緯	纬
緰	□
緱	缑
緲	缈
緳	緳
練	练
緵	□
緶	缏
緷	□
緸	□
緹	缇
緺	□
緻	致
緼	缊
緽	□
緾	缠
緿	□
縀	□
縁	□
縂	总
縃	□
縆	□
縈	萦
縉	缙
縊	缢
縋	缒
縌	□
縍	□
縎	□
縏	縏
縐	绉
縑	缣
縒	□
縓	□
縔	□
縕	缊
縖	□
縗	缞
縘	□
縙	□
縚	□
縛	缚
縜	□
縝	缜
縞	缟
縟	缛
縠	縠
縡	□
縢	縢
縣	县
縤	□
縥	□
縦	纵
縧	绦
縩	□
縪	□
縫	缝
縬	□
縭	缡
縮	缩
縯	□
縰	□
縱	纵
縲	缧
縳	□
縴	□
縵	缦
縶	絷
縷	缕
縸	□
縹	缥
縺	□
縻	縻
縼	□
總	总
績	绩
縿	□
繀	□
繁	繁
繂	□
繃	绷
繄	繄
繅	缫
繆	缪
繇	繇
繈	□
繉	□
繋	繋
繍	绣
繎	□
繏	□
繐	□
繑	□
繒	缯
繓	□
織	织
繕	缮
繖	□
繗	□
繘	□
繙	□
繚	缭
繛	繛
繜	□
繝	□
繞	绕
繟	□
繠	繠
繡	绣
繢	缋
繣	□
繤	繤
繥	□
繦	□
繨	□
繩	绳
繪	绘
繫	系
繬	□
繭	茧
繮	缰
繯	缳
繰	缲
繱	□
繲	□
繳	缴
繴	繴
繵	□
繶	□
繷	□
繸	□
繹	绎
繺	□
繻	□
繼	继
繽	缤
繾	缱
繿	□
纀	□
纁	□
纂	纂
纃	□
纄	□
纅	□
纆	□
纇	颣
纈	缬
纉	□
纊	纩
纋	□
續	续
纍	纍
纎	□
纏	缠
纑	□
纒	缠
纓	缨
纔	才
纕	□
纖	纤
纗	□
纘	缵
纙	□
纚	□
纛	纛
纜	缆
纝	□
纞	□
缶	缶
缷	缷
缸	缸
缹	缹
缺	缺
缻	缻
缽	钵
缾	缾
缿	缿
罁	□
罃	□
罄	罄
罅	罅
罆	□
罇	罇
罈	坛
罉	罉
罊	□
罋	罋
罌	罂
罍	罍
罎	坛
罏	□
罐	罐
罒	罒
罓	罓
罔	罔
罕	罕
罘	罘
罙	罙
罛	罛
罜	罜
罝	罝
罞	罞
罟	罟
罠	罠
罡	罡
罣	罣
罤	罤
罥	罥
罦	罦
罧	罧
罨	罨
罩	罩
罪	罪
罫	罫
罬	罬
罭	罭
置	置
罯	罯
罰	罚
罱	罱
署	署
罳	罳
罵	骂
罶	罶
罷	罢
罸	罚
罹	罹
罺	罺
罻	罻
罼	□
罽	罽
罾	罾
罿	罿
羀	羀
羂	□
羃	羃
羄	□
羅	罗
羆	罴
羇	羇
羈	羁
羉	□
羊	羊
羋	羋
羌	羌
羍	羍
美	美
羏	羏
羐	羐
羑	羑
羒	羒
羓	羓
羔	羔
羕	羕
羖	羖
羗	羗
羘	羘
羙	羙
羚	羚
羛	羛
羜	羜
羝	羝
羞	羞
羠	羠
羢	羢
羣	羣
群	群
羥	羟
羦	羦
羧	羧
羨	羡
義	义
羫	羫
羬	羬
羭	羭
羮	羮
羯	羯
羰	羰
羱	羱
羲	羲
羳	羳
羴	羶
羵	□
羶	羶
羷	□
羸	羸
羹	羹
羺	羺
羻	□
羼	羼
羽	羽
羾	羾
羿	羿
翀	翀
翁	翁
翂	翂
翃	翃
翄	翄
翅	翅
翆	翆
翇	翇
翈	翈
翉	翉
翊	翊
翋	翋
翌	翌
翍	翍
翎	翎
翏	翏
翐	翐
翑	翑
習	习
翓	翓
翔	翔
翕	翕
翖	翖
翗	翗
翛	翛
翜	□
翝	翝
翞	翞
翟	翟
翠	翠
翡	翡
翢	翢
翣	翣
翤	翤
翥	翥
翦	翦
翧	翧
翨	翨
翩	翩
翪	翪
翫	翫
翬	翚
翭	翭
翮	翮
翯	翯
翰	翰
翲	翲
翳	翳
翴	□
翵	□
翷	翷
翸	□
翹	翘
翺	翱
翻	翻
翼	翼
翽	翙
翾	翾
翿	□
耀	耀
老	老
耂	耂
考	考
耄	耄
者	者
耆	耆
耇	耇
耈	耈
耉	耉
耊	耊
耋	耋
而	而
耍	耍
耎	耎
耏	耏
耐	耐
耑	耑
耒	耒
耓	耓
耔	耔
耕	耕
耖	耖
耗	耗
耘	耘
耙	耙
耚	耚
耛	耛
耜	耜
耝	耝
耞	耞
耟	耟
耠	耠
耡	耡
耣	□
耤	耤
耥	耥
耦	耦
耨	耨
耩	耩
耪	耪
耫	耫
耬	耧
耭	□
耮	耢
耯	耯
耰	耰
耱	耱
耲	耲
耴	耴
耵	耵
耶	耶
耷	耷
耹	耹
耺	耺
耼	耼
耽	耽
耾	耾
耿	耿
聀	聀
聃	聃
聄	聄
聅	聅
聆	聆
聇	聇
聈	聈
聉	聉
聊	聊
聎	聎
聏	聏
聐	聐
聑	聑
聒	聒
聕	聕
聖	圣
聗	□
聘	聘
聙	聙
聚	聚
聛	聛
聜	聜
聝	聝
聞	闻
聟	聟
聠	聠
聡	聡
聤	聤
聥	聥
聦	聦
聧	聧
聫	聫
聬	聬
聭	聭
聮	□
聯	联
聰	聪
聱	聱
聲	声
聳	耸
聴	听
聵	聩
聶	聂
職	职
聸	聸
聹	聍
聻	□
聼	听
聽	听
聾	聋
聿	聿
肀	肀
肁	肁
肂	肂
肄	肄
肅	肃
肆	肆
肇	肇
肈	肈
肉	肉
肊	肊
肋	肋
肌	肌
肍	肍
肎	肎
肏	肏
肐	肐
肑	肑
肒	肒
肓	肓
肔	肔
肕	肕
肖	肖
肗	肗
肘	肘
肙	肙
肚	肚
肛	肛
肜	肜
肝	肝
肞	肞
肟	肟
股	股
肢	肢
肣	肣
肥	肥
肦	肦
肧	肧
肨	肨
肩	肩
肪	肪
肫	肫
肬	肬
肭	肭
肮	肮
肯	肯
肰	肰
肱	肱
育	育
肳	肳
肵	肵
肶	肶
肷	肷
肸	肸
肹	肹
肺	肺
肻	肻
肼	肼
肽	肽
胂	胂
胃	胃
胄	胄
胅	胅
胇	胇
胈	胈
胉	胉
胊	胊
胋	胋
背	背
胍	胍
胎	胎
胏	胏
胐	胐
胑	胑
胒	胒
胓	胓
胔	胔
胕	胕
胖	胖
胗	胗
胘	胘
胙	胙
胚	胚
胛	胛
胝	胝
胞	胞
胟	胟
胠	胠
胡	胡
胢	胢
胣	胣
胤	胤
胥	胥
胦	胦
胩	胩
胬	胬
胭	胭
胮	胮
胯	胯
胰	胰
胱	胱
胲	胲
胳	胳
胴	胴
胵	胵
胷	胷
胸	胸
胹	胹
胺	胺
胻	胻
能	能
胾	胾
脀	脀
脁	脁
脂	脂
脃	脃
脄	脄
脅	胁
脆	脆
脇	脇
脈	脉
脊	脊
脎	脎
脒	脒
脕	脕
脖	脖
脗	脗
脘	脘
脙	脙
脛	胫
脜	脜
脝	脝
脞	脞
脟	脟
脠	脠
脡	脡
脢	脢
脣	脣
脤	脤
脥	□
脦	脦
脧	脧
脨	脨
脩	脩
脪	脪
脫	脱
脬	脬
脭	脭
脮	脮
脯	脯
脰	脰
脲	脲
脴	脴
脵	脵
脷	脷
脹	胀
脺	脺
脼	□
脽	脽
脾	脾
脿	脿
腀	□
腁	胼
腂	腂
腃	腃
腄	腄
腅	腅
腆	腆
腇	腇
腈	腈
腉	腉
腋	腋
腍	腍
腎	肾
腏	腏
腐	腐
腑	腑
腒	腒
腓	腓
腔	腔
腕	腕
腖	胨
腗	腗
腙	腙
腚	腚
腛	腛
腜	腜
腝	腝
腞	腞
腟	腟
腠	腠
腡	脶
腢	腢
腣	腣
腤	腤
腥	腥
腦	脑
腧	腧
腨	腨
腩	腩
腪	□
腫	肿
腬	腬
腭	腭
腮	腮
腯	腯
腰	腰
腱	腱
腲	腲
腳	脚
腴	腴
腵	腵
腶	腶
腷	腷
腸	肠
腹	腹
腺	腺
腿	腿
膀	膀
膁	膁
膂	膂
膃	腽
膄	膄
膅	膅
膆	膆
膇	膇
膈	膈
膉	膉
膊	膊
膋	□
膌	膌
膍	膍
膎	膎
膏	膏
膐	膐
膓	肠
膔	膔
膕	腘
膖	膖
膗	膗
膘	膘
膙	膙
膚	肤
膛	膛
膜	膜
膝	膝
膞	□
膟	膟
膠	胶
膡	膡
膢	□
膣	膣
膥	膥
膦	膦
膧	膧
膨	膨
膩	腻
膪	膪
膫	膫
膬	膬
膭	□
膮	□
膯	膯
膰	膰
膱	□
膲	膲
膳	膳
膴	□
膵	膵
膶	□
膷	□
膸	□
膹	□
膺	膺
膻	膻
膼	□
膽	胆
膾	脍
膿	脓
臀	臀
臁	臁
臂	臂
臃	臃
臄	臄
臅	臅
臆	臆
臇	臇
臈	臈
臉	脸
臊	臊
臋	臋
臌	臌
臍	脐
臎	臎
臏	膑
臐	臐
臑	臑
臒	臒
臓	脏
臔	□
臕	臕
臖	臖
臗	□
臘	腊
臙	臙
臚	胪
臛	臛
臝	臝
臞	臞
臟	脏
臠	脔
臡	□
臢	臜
臣	臣
臤	臤
臥	卧
臧	臧
臨	临
臩	臩
自	自
臫	臫
臬	臬
臭	臭
臮	臮
臯	臯
臰	臰
臱	臱
臲	臲
至	至
致	致
臵	臵
臶	臶
臷	臷
臸	臸
臹	臹
臺	台
臻	臻
臼	臼
臽	臽
臾	臾
臿	臿
舀	舀
舁	舁
舂	舂
舃	舃
舄	舄
舅	舅
與	与
興	兴
舉	举
舊	旧
舋	舋
舌	舌
舍	舍
舏	舏
舐	舐
舑	舑
舒	舒
舓	舓
舔	舔
舕	舕
舖	铺
舗	铺
舘	舘
舙	舙
舚	舚
舛	舛
舜	舜
舝	舝
舞	舞
舟	舟
舠	舠
舡	舡
舢	舢
舥	舥
舦	舦
舧	舧
舨	舨
舩	舩
航	航
舫	舫
般	般
舭	舭
舯	舯
舲	舲
舳	舳
舴	舴
舵	舵
舶	舶
舷	舷
舸	舸
船	船
舺	舺
舼	舼
舽	舽
舾	舾
艀	艀
艁	艁
艂	艂
艃	艃
艄	艄
艅	艅
艆	艆
艇	艇
艉	艉
艊	艊
艋	艋
艌	艌
艍	艍
艎	艎
艏	艏
艐	艐
艑	艑
艒	艒
艓	艓
艕	艕
艖	艖
艗	艗
艘	艘
艙	舱
艚	艚
艛	□
艜	□
艞	艞
艟	艟
艡	□
艢	□
艣	□
艤	舣
艥	艥
艦	舰
艧	艧
艨	艨
艩	□
艪	□
艫	舻
艬	艬
艭	□
良	良
艱	艰
色	色
艴	艴
艵	艵
艶	艳
艷	艳
艸	艸
艹	艹
艻	艻
艼	艼
艽	艽
艾	艾
艿	艿
芀	芀
芁	芁
芃	芃
芄	芄
芅	芅
芆	芆
芇	芇
芈	芈
芉	芉
芊	芊
芋	芋
芌	芌
芍	芍
芎	芎
芏	芏
芐	芐
芑	芑
芒	芒
芓	芓
芔	芔
芕	芕
芖	芖
芘	芘
芙	芙
芚	芚
芛	芛
芝	芝
芞	芞
芟	芟
芠	芠
芡	芡
芢	芢
芣	芣
芤	芤
芥	芥
芧	芧
芨	芨
芩	芩
芪	芪
芫	芫
芬	芬
芭	芭
芮	芮
芯	芯
芰	芰
花	花
芲	芲
芳	芳
芴	芴
芵	芵
芶	芶
芷	芷
芸	芸
芹	芹
芺	芺
芻	刍
芼	芼
芽	芽
芾	芾
芿	芿
苀	苀
苂	苂
苃	苃
苄	苄
苅	苅
苉	苉
苊	苊
苐	苐
苑	苑
苒	苒
苓	苓
苔	苔
苕	苕
苖	苖
苗	苗
苘	苘
苙	苙
苚	苚
苛	苛
苜	苜
苝	苝
苞	苞
苟	苟
苠	苠
苡	苡
苢	苢
苣	苣
苤	苤
若	若
苦	苦
苧	苎
苨	苨
苩	苩
苪	苪
苫	苫
苬	苬
苭	苭
苮	苮
苯	苯
苰	苰
英	英
苲	苲
苳	苳
苴	苴
苵	苵
苶	苶
苷	苷
苸	苸
苺	苺
苻	苻
苼	苼
苽	苽
苾	苾
苿	苿
茀	茀
茁	茁
茂	茂
范	范
茄	茄
茅	茅
茆	茆
茇	茇
茈	茈
茉	茉
茊	茊
茋	茋
茌	茌
茍	茍
茓	茓
茖	茖
茗	茗
茘	茘
茙	茙
茚	茚
茛	茛
茜	茜
茝	茝
茞	茞
茟	茟
茠	茠
茡	茡
茢	茢
茣	□
茤	茤
茥	茥
茦	茦
茨	茨
茩	茩
茪	茪
茫	茫
茬	茬
茭	茭
茮	茮
茯	茯
茰	茰
茱	茱
茲	兹
茳	茳
茴	茴
茵	茵
茶	茶
茷	茷
茸	茸
茹	茹
茺	茺
茻	茻
茼	茼
茽	茽
茿	茿
荀	荀
荁	荁
荂	荂
荃	荃
荄	荄
荅	荅
荇	荇
荈	荈
草	草
荊	荆
荋	荋
荌	荌
荍	荍
荎	荎
荏	荏
荑	荑
荒	荒
荓	荓
荔	荔
荕	荕
荖	荖
荗	荗
荘	庄
荰	荰
荱	荱
荲	荲
荳	荳
荴	荴
荵	荵
荶	荶
荷	荷
荸	荸
荹	荹
荺	荺
荻	荻
荼	荼
荽	荽
荾	荾
荿	荿
莀	莀
莁	莁
莂	莂
莃	莃
莄	莄
莆	莆
莇	莇
莈	莈
莉	莉
莊	庄
莋	莋
莌	莌
莍	莍
莎	莎
莏	莏
莐	莐
莑	莑
莒	莒
莓	莓
莔	莔
莕	莕
莖	茎
莗	□
莘	莘
莙	莙
莚	莚
莛	莛
莜	莜
莝	莝
莞	莞
莟	莟
莠	莠
莡	莡
莢	荚
莣	莣
莤	莤
莥	莥
莦	莦
莧	苋
莨	莨
莩	莩
莪	莪
莫	莫
莬	莬
莭	莭
莮	莮
莯	莯
莰	莰
莽	莽
莾	莾
莿	莿
菀	菀
菁	菁
菂	菂
菃	菃
菄	□
菅	菅
菆	菆
菇	菇
菈	菈
菉	菉
菊	菊
菋	菋
菌	菌
菍	菍
菎	菎
菏	菏
菐	菐
菑	菑
菒	菒
菓	果
菔	菔
菕	□
菖	菖
菗	菗
菘	菘
菙	菙
菚	□
菛	□
菜	菜
菝	菝
菞	菞
菟	菟
菠	菠
菡	菡
菢	菢
菣	□
菤	菤
菥	菥
菦	菦
菧	菧
菨	菨
菩	菩
菪	菪
菫	菫
菬	菬
菭	菭
菮	菮
華	华
菰	菰
菱	菱
菲	菲
菳	菳
菴	菴
菵	菵
菶	菶
菷	菷
菸	烟
菹	菹
菺	菺
菻	菻
菼	菼
菽	菽
菾	菾
菿	菿
萀	萀
萁	萁
萂	萂
萃	萃
萄	萄
萅	萅
萆	萆
萇	苌
萈	□
萉	萉
萊	莱
萋	萋
萌	萌
萍	萍
萎	萎
萏	萏
萐	萐
萒	萒
萓	萓
萔	萔
萕	荠
萖	萖
萗	萗
萘	萘
萛	萛
萜	萜
萠	萠
萩	萩
萪	萪
萫	萫
萬	万
萭	萭
萮	萮
萯	□
萰	萰
萱	萱
萲	萲
萳	萳
萴	荝
萵	莴
萶	萶
萷	萷
萸	萸
萹	萹
萺	萺
萻	萻
萼	萼
落	落
萾	萾
萿	萿
葀	葀
葁	葁
葂	葂
葃	葃
葄	葄
葅	葅
葆	葆
葇	葇
葈	葈
葉	叶
葊	葊
葋	葋
葌	葌
葍	葍
葎	葎
葏	葏
葐	葐
葑	葑
葒	荭
葓	葓
葔	葔
葕	葕
葖	葖
著	着
著	著
葘	葘
葙	葙
葚	葚
葛	葛
葜	葜
葝	□
葞	葞
葟	葟
葠	葠
葡	葡
葢	葢
董	董
葤	荮
葥	葥
葦	苇
葧	葧
葨	葨
葩	葩
葪	葪
葫	葫
葬	葬
葭	葭
葮	葮
葯	药
葰	葰
葲	葲
葳	葳
葴	葴
葵	葵
葶	葶
葷	荤
葸	葸
葹	葹
葺	葺
葻	□
葼	葼
葽	葽
葾	葾
葿	葿
蒁	蒁
蒂	蒂
蒃	蒃
蒄	蒄
蒆	蒆
蒈	蒈
蒍	□
蒎	蒎
蒐	蒐
蒑	蒑
蒒	□
蒓	莼
蒔	莳
蒕	蒀
蒖	蒖
蒗	蒗
蒘	蒘
蒙	蒙
蒚	蒚
蒛	蒛
蒜	蒜
蒝	蒝
蒞	莅
蒟	蒟
蒠	蒠
蒡	蒡
蒢	蒢
蒣	蒣
蒤	蒤
蒥	蒥
蒦	蒦
蒧	蒧
蒨	蒨
蒩	蒩
蒪	蒪
蒫	蒫
蒬	蒬
蒭	蒭
蒮	蒮
蒯	蒯
蒰	蒰
蒱	蒱
蒲	蒲
蒳	□
蒴	蒴
蒵	蒵
蒶	□
蒷	□
蒸	蒸
蒹	蒹
蒺	蒺
蒻	蒻
蒼	苍
蒽	蒽
蒾	蒾
蒿	蒿
蓀	荪
蓁	蓁
蓂	蓂
蓃	蓃
蓄	蓄
蓅	蓅
蓆	蓆
蓇	蓇
蓈	蓈
蓉	蓉
蓊	蓊
蓋	盖
蓌	蓌
蓍	蓍
蓎	蓎
蓏	蓏
蓐	蓐
蓑	蓑
蓒	□
蓓	蓓
蓔	蓔
蓕	蓕
蓖	蓖
蓗	蓗
蓚	蓚
蓛	蓛
蓡	蓡
蓢	蓢
蓧	蓧
蓨	蓨
蓩	□
蓪	蓪
蓫	蓫
蓬	蓬
蓭	蓭
蓮	莲
蓯	苁
蓰	蓰
蓱	蓱
蓲	□
蓳	蓳
蓴	□
蓵	蓵
蓶	蓶
蓷	蓷
蓸	蓸
蓹	蓹
蓺	□
蓻	□
蓼	蓼
蓽	荜
蓾	□
蓿	蓿
蔀	蔀
蔁	蔁
蔂	蔂
蔃	蔃
蔄	□
蔅	□
蔆	蔆
蔇	蔇
蔈	蔈
蔉	蓘
蔊	蔊
蔋	蔋
蔌	蔌
蔍	蔍
蔎	□
蔏	蔏
蔐	蔐
蔑	蔑
蔒	蔒
蔓	蔓
蔔	卜
蔕	□
蔖	蔖
蔗	蔗
蔘	□
蔙	蔙
蔚	蔚
蔛	蔛
蔜	蔜
蔝	蔝
蔞	蒌
蔟	蔟
蔠	蔠
蔡	蔡
蔢	蔢
蔣	蒋
蔤	蔤
蔥	葱
蔦	茑
蔧	蔧
蔨	蔨
蔩	蔩
蔪	□
蔫	蔫
蔬	蔬
蔭	荫
蔮	□
蔯	□
蔰	蔰
蔱	□
蔲	蔲
蔳	蔳
蔴	麻
蔵	蔵
蔸	蔸
蔻	蔻
蔽	蔽
蔾	蔾
蔿	□
蕀	蕀
蕁	荨
蕂	蕂
蕃	蕃
蕄	□
蕅	蕅
蕆	蒇
蕇	□
蕈	蕈
蕉	蕉
蕊	蕊
蕋	蕋
蕌	蕌
蕍	蕍
蕎	荞
蕐	蕐
蕑	□
蕒	荬
蕓	芸
蕔	蕔
蕕	莸
蕖	蕖
蕗	蕗
蕘	荛
蕙	蕙
蕚	蕚
蕛	蕛
蕜	蕜
蕝	□
蕞	蕞
蕟	□
蕠	蕠
蕡	□
蕢	蒉
蕣	蕣
蕤	蕤
蕥	蕥
蕦	□
蕧	□
蕨	蕨
蕩	荡
蕪	芜
蕫	蕫
蕬	□
蕭	萧
蕮	蕮
蕯	蕯
蕳	□
蕵	蕵
蕶	蕶
蕷	蓣
蕸	蕸
蕹	蕹
蕺	蕺
蕻	蕻
蕼	蕼
蕽	□
蕾	蕾
蕿	蕿
薀	蕰
薁	□
薂	薂
薃	薃
薄	薄
薅	薅
薆	□
薇	薇
薈	荟
薉	薉
薊	蓟
薋	□
薌	芗
薍	□
薎	薎
薏	薏
薐	薐
薑	姜
薒	薒
薓	薓
薔	蔷
薕	薕
薖	□
薗	□
薘	荙
薙	薙
薚	□
薛	薛
薜	薜
薝	薝
薞	薞
薟	莶
薠	□
薡	薡
薢	薢
薣	薣
薤	薤
薥	薥
薦	荐
薧	薧
薨	薨
薩	萨
薪	薪
薫	薰
薬	药
薯	薯
薰	薰
薱	□
薲	□
薳	䓕
薴	□
薵	□
薶	薶
薷	薷
薸	薸
薹	薹
薺	荠
薻	薻
薼	薼
薽	薽
薾	薾
薿	薿
藀	□
藁	藁
藂	藂
藃	藃
藄	藄
藅	□
藆	藆
藇	□
藈	藈
藉	借
藊	藊
藋	藋
藌	藌
藍	蓝
藎	荩
藏	藏
藐	藐
藑	藑
藒	藒
藕	藕
藖	□
藗	藗
藘	□
藙	藙
藚	□
藛	□
藜	藜
藝	艺
藞	藞
藟	藟
藠	藠
藡	藡
藢	藢
藣	□
藤	藤
藥	药
藦	藦
藧	□
藨	藨
藩	藩
藪	薮
藫	藫
藬	□
藭	藭
藮	藮
藯	藯
藰	□
藱	藱
藳	藳
藴	蕴
藶	苈
藷	□
藸	蕏
藹	蔼
藺	蔺
藻	藻
藼	藼
藽	藽
藾	□
藿	藿
蘀	萚
蘁	蘁
蘂	蘂
蘃	蘃
蘄	蕲
蘅	蘅
蘆	芦
蘇	苏
蘈	□
蘉	蘉
蘊	蕴
蘋	苹
蘌	蘌
蘍	薫
蘎	蘎
蘐	□
蘑	蘑
蘓	□
蘔	□
蘖	蘖
蘗	蘗
蘘	蘘
蘙	蘙
蘚	藓
蘛	蘛
蘜	蘜
蘝	□
蘞	蔹
蘟	□
蘠	□
蘡	蘡
蘢	茏
蘣	蘣
蘤	□
蘥	蘥
蘦	蘦
蘧	蘧
蘨	蘨
蘩	蘩
蘪	蘪
蘫	□
蘬	□
蘭	兰
蘮	蘮
蘯	蘯
蘱	□
蘲	蘲
蘳	蘳
蘴	蘴
蘵	□
蘶	蘶
蘷	蘷
蘸	蘸
蘹	蘹
蘺	蓠
蘻	□
蘼	蘼
蘽	蘽
蘾	蘾
蘿	萝
虀	虀
虁	虁
虂	虂
虃	□
虆	虆
虇	虇
虈	□
虉	□
虊	□
虋	虋
虌	虌
虍	虍
虎	虎
虐	虐
虒	虒
虓	虓
虔	虔
處	处
虖	虖
虗	虗
虘	虘
虙	虙
虛	虚
虜	虏
虝	虝
虞	虞
號	号
虠	虠
虡	虡
虢	虢
虣	虣
虤	虤
虥	□
虦	□
虧	亏
虨	虨
虩	虩
虪	虪
虭	虭
虯	虬
虰	虰
虱	虱
虳	虳
虴	虴
虵	虵
虶	虶
虷	虷
虸	虸
虹	虹
虺	虺
虻	虻
虼	虼
蚄	蚄
蚅	蚅
蚆	蚆
蚇	蚇
蚈	蚈
蚉	蚉
蚊	蚊
蚋	蚋
蚌	蚌
蚍	蚍
蚎	蚎
蚏	蚏
蚐	蚐
蚑	蚑
蚒	蚒
蚓	蚓
蚔	蚔
蚖	蚖
蚗	蚗
蚘	蚘
蚙	蚙
蚚	蚚
蚛	蚛
蚜	蚜
蚝	蚝
蚞	蚞
蚟	蚟
蚠	蚠
蚡	蚡
蚢	蚢
蚣	蚣
蚤	蚤
蚥	蚥
蚦	蚦
蚧	蚧
蚨	蚨
蚩	蚩
蚪	蚪
蚫	蚫
蚭	蚭
蚮	蚮
蚯	蚯
蚰	蚰
蚱	蚱
蚲	蚲
蚳	蚳
蚴	蚴
蚵	蚵
蚶	蚶
蚷	蚷
蚸	蚸
蚹	蚹
蚺	蚺
蚻	蚻
蚼	蚼
蚽	蚽
蚾	蚾
蚿	蚿
蛀	蛀
蛁	蛁
蛂	蛂
蛃	蛃
蛄	蛄
蛅	蛅
蛆	蛆
蛇	蛇
蛈	蛈
蛉	蛉
蛋	蛋
蛌	蛌
蛍	萤
蛐	蛐
蛑	蛑
蛒	蛒
蛓	蛓
蛔	蛔
蛕	蛕
蛖	蛖
蛗	蛗
蛘	蛘
蛙	蛙
蛚	蛚
蛛	蛛
蛜	蛜
蛝	蛝
蛞	蛞
蛟	蛟
蛠	蛠
蛡	蛡
蛢	蛢
蛣	蛣
蛤	蛤
蛥	蛥
蛦	蛦
蛨	蛨
蛩	蛩
蛪	蛪
蛫	蛫
蛬	蛬
蛭	蛭
蛵	□
蛶	蛶
蛷	蛷
蛸	蛸
蛹	蛹
蛺	蛱
蛻	蜕
蛼	□
蛽	□
蛾	蛾
蛿	蛿
蜀	蜀
蜁	蜁
蜂	蜂
蜃	蜃
蜄	蜄
蜅	蜅
蜆	蚬
蜇	蜇
蜈	蜈
蜉	蜉
蜊	蜊
蜋	蜋
蜌	蜌
蜍	蜍
蜎	蜎
蜏	蜏
蜑	蜑
蜒	蜒
蜓	蜓
蜔	蜔
蜖	蛔
蜘	蜘
蜙	蜙
蜚	蜚
蜛	蜛
蜜	蜜
蜝	蜝
蜞	蜞
蜟	蜟
蜠	蜠
蜢	蜢
蜣	蜣
蜤	蜤
蜥	蜥
蜦	□
蜧	蜧
蜨	蜨
蜩	蜩
蜪	蜪
蜫	蜫
蜬	蜬
蜭	蜭
蜮	蜮
蜯	蜯
蜰	蜰
蜱	蜱
蜲	蜲
蜳	蜳
蜴	蜴
蜵	□
蜶	蜶
蜷	蜷
蜸	□
蜹	蜹
蜺	蜺
蜻	蜻
蜼	蜼
蜽	□
蜾	蜾
蜿	蜿
蝀	□
蝁	□
蝂	蝂
蝃	蝃
蝄	蛧
蝅	蝅
蝆	蝆
蝋	蜡
蝌	蝌
蝍	蝍
蝎	蝎
蝏	蝏
蝐	蝐
蝑	蝑
蝒	蝒
蝓	蝓
蝔	蝔
蝕	蚀
蝖	蝖
蝗	蝗
蝘	蝘
蝙	蝙
蝚	蝚
蝛	蝛
蝜	□
蝝	蝝
蝞	蝞
蝟	猬
蝠	蝠
蝡	蝡
蝢	□
蝣	蝣
蝤	蝤
蝥	蝥
蝦	虾
蝧	蝧
蝨	虱
蝩	蝩
蝪	□
蝫	蝫
蝬	蝬
蝭	蝭
蝮	蝮
蝯	蝯
蝰	蝰
蝱	蝱
蝲	蝲
蝳	蝳
蝴	蝴
蝵	蝵
蝶	蝶
蝷	蝷
蝸	蜗
蝹	蝹
蝺	蝺
蝻	蝻
蝽	蝽
蝿	蝇
螂	螂
螃	螃
螄	蛳
螅	螅
螆	螆
螇	螇
螈	螈
螉	螉
螊	螊
螋	螋
螌	螌
融	融
螎	螎
螏	螏
螐	□
螑	螑
螒	螒
螓	螓
螔	螔
螕	螕
螖	螖
螗	螗
螘	□
螙	螙
螚	螚
螛	螛
螜	螜
螝	螝
螞	蚂
螟	螟
螠	螠
螡	螡
螢	萤
螣	螣
螤	螤
螥	□
螪	螪
螫	螫
螬	螬
螭	螭
螮	□
螯	螯
螰	螰
螱	螱
螲	螲
螳	螳
螴	□
螵	螵
螶	螶
螷	螷
螸	螸
螹	□
螺	螺
螻	蝼
螼	螼
螽	螽
螾	螾
螿	螀
蟀	蟀
蟁	蟁
蟂	□
蟃	蟃
蟄	蛰
蟅	蟅
蟆	蟆
蟇	蟇
蟈	蝈
蟉	蟉
蟊	蟊
蟋	蟋
蟌	蟌
蟍	蟍
蟎	螨
蟑	蟑
蟒	蟒
蟓	蟓
蟔	蟔
蟕	蟕
蟖	蟖
蟗	蟗
蟘	蟘
蟙	□
蟚	蟚
蟛	蟛
蟜	□
蟝	蟝
蟞	蟞
蟟	蟟
蟠	蟠
蟡	□
蟢	蟢
蟣	虮
蟤	蟤
蟥	蟥
蟦	□
蟧	□
蟨	蟨
蟩	蟩
蟪	蟪
蟫	蟫
蟬	蝉
蟭	蟭
蟮	蟮
蟯	蛲
蟰	□
蟱	□
蟲	虫
蟳	□
蟴	蟴
蟶	蛏
蟷	□
蟸	蟸
蟹	蟹
蟺	蟺
蟻	蚁
蟼	蟼
蟽	□
蟾	蟾
蟿	□
蠀	□
蠁	蚃
蠂	蠂
蠃	蠃
蠄	蠄
蠅	蝇
蠆	虿
蠇	□
蠈	□
蠉	蠉
蠊	蠊
蠋	蠋
蠌	□
蠍	蠍
蠎	蠎
蠏	蠏
蠐	蛴
蠑	蝾
蠒	□
蠓	蠓
蠔	蚝
蠕	蠕
蠖	蠖
蠗	蠗
蠘	蠘
蠙	□
蠚	蠚
蠛	蠛
蠜	蠜
蠝	蠝
蠟	蜡
蠠	蠠
蠡	蠡
蠢	蠢
蠣	蛎
蠤	蠤
蠥	蠥
蠦	□
蠧	蠧
蠨	蟏
蠩	□
蠪	□
蠫	蠫
蠬	□
蠭	蠭
蠮	蠮
蠯	蠯
蠰	蠰
蠱	蛊
蠲	蠲
蠳	□
蠵	蠵
蠶	蚕
蠷	蠷
蠸	蠸
蠹	蠹
蠺	蚕
蠻	蛮
蠼	蠼
蠽	蠽
蠾	蠾
蠿	蠿
血	血
衁	衁
衂	衂
衃	衃
衄	衄
衆	众
衇	衇
衈	衈
衉	衉
衊	蔑
衋	衋
行	行
衍	衍
衎	衎
衏	衏
衑	衑
衒	衒
術	术
衕	同
衖	衖
街	街
衘	衘
衙	衙
衚	胡
衛	卫
衜	衜
衝	冲
衞	卫
衟	衟
衠	衠
衡	衡
衢	衢
衣	衣
衤	衤
衦	衦
衧	衧
表	表
衩	衩
衪	衪
衫	衫
衭	衭
衯	衯
衰	衰
衲	衲
衳	衳
衴	衴
衵	衵
衶	衶
衷	衷
衸	衸
衹	衹
衺	衺
衻	衻
衼	衼
衽	衽
衾	衾
衿	衿
袀	袀
袁	袁
袂	袂
袃	袃
袇	袇
袈	袈
袉	袉
袊	袊
袋	袋
袌	袌
袍	袍
袎	袎
袏	袏
袐	袐
袑	袑
袒	袒
袓	袓
袔	袔
袕	袕
袖	袖
袗	袗
袘	袘
袙	袙
袚	袚
袛	袛
袝	袝
袞	衮
袟	袟
袠	袠
袡	袡
袢	袢
袣	袣
袤	袤
袦	袦
袧	袧
袨	袨
袩	袩
袪	袪
被	被
袬	袬
袱	袱
袲	袲
袳	袳
袴	袴
袵	袵
袶	袶
袷	袷
袸	袸
袹	袹
袺	袺
袻	袻
袼	袼
袽	袽
袾	袾
袿	袿
裀	裀
裁	裁
裂	裂
裉	裉
裊	袅
裋	裋
裌	□
裍	裍
裎	裎
裏	里
裐	裐
裑	裑
裒	裒
裓	裓
裔	裔
裕	裕
裖	裖
裗	裗
裘	裘
裙	裙
裚	裚
裛	裛
補	补
裝	装
裞	裞
裟	裟
裠	裠
裡	里
裦	裦
裧	裧
裨	裨
裩	裩
裪	裪
裫	□
裬	裬
裭	裭
裮	裮
裯	裯
裰	裰
裱	裱
裲	□
裳	裳
裴	裴
裵	裵
裶	裶
裷	裷
裸	裸
裹	裹
裺	裺
裻	裻
裼	裼
製	制
裾	裾
裿	裿
褀	褀
褁	褁
褂	褂
褃	褃
褅	褅
褆	褆
複	复
褈	褈
褉	褉
褊	褊
褋	褋
褌	裈
褍	褍
褎	褎
褏	褏
褐	褐
褑	褑
褒	褒
褓	褓
褔	褔
褕	褕
褖	褖
褗	褗
褘	袆
褙	褙
褚	褚
褞	褞
褟	褟
褠	褠
褡	褡
褢	褢
褣	褣
褤	褤
褥	褥
褦	褦
褧	褧
褨	褨
褩	褩
褪	褪
褫	褫
褬	褬
褭	□
褮	□
褯	褯
褰	褰
褱	褱
褲	裤
褳	裢
褵	褵
褶	褶
褷	褷
褸	褛
褹	□
褺	□
褻	亵
褼	褼
褽	褽
褾	褾
褿	褿
襀	□
襁	□
襂	□
襃	襃
襄	襄
襆	襆
襇	裥
襈	襈
襉	□
襊	襊
襋	襋
襌	□
襍	襍
襎	襎
襏	袯
襐	襐
襑	□
襒	襒
襓	□
襔	□
襖	袄
襗	□
襘	□
襙	襙
襚	襚
襛	□
襜	襜
襝	裣
襞	襞
襟	襟
襠	裆
襡	襡
襢	襢
襣	襣
襤	褴
襥	襥
襦	襦
襧	□
襩	□
襪	袜
襫	襫
襬	摆
襭	□
襮	襮
襯	衬
襰	□
襱	□
襲	袭
襳	襳
襴	襕
襵	□
襶	襶
襸	□
襹	□
襺	□
襻	襻
襼	□
襾	襾
西	西
覀	覀
要	要
覂	覂
覃	覃
覅	覅
覆	覆
覇	霸
覈	覈
覉	覉
覊	羁
見	见
覌	观
覍	□
覎	觃
規	规
覐	□
覑	□
覒	□
覓	觅
覔	□
覕	□
視	视
覗	□
覘	觇
覙	□
覚	觉
覛	□
覜	□
覝	□
覞	□
覟	□
覠	□
覡	觋
覢	□
覣	□
覤	□
覥	觍
覦	觎
覧	览
覨	□
覩	□
親	亲
覫	□
覬	觊
覭	□
覮	□
覯	觏
覰	□
覱	□
覲	觐
観	观
覴	覴
覵	□
覶	□
覷	觑
覸	□
覹	□
覺	觉
覻	□
覼	□
覽	览
覾	□
覿	觌
觀	观
觓	觓
觔	筋
觕	觕
觖	觖
觗	觗
觘	觘
觙	觙
觚	觚
觛	觛
觜	觜
觝	觝
觟	觟
觠	觠
觡	觡
觢	觢
解	解
觤	觤
觥	觥
觧	觧
觨	觨
觩	觩
觪	觪
觫	觫
觬	觬
觭	觭
觮	觮
觰	觰
觱	觱
觲	觲
觳	觳
觴	觞
觵	觵
觶	觯
觷	□
觸	触
觹	□
觺	觺
觻	□
觼	觼
觽	□
觾	觾
觿	□
言	言
訁	讠
訂	订
訃	讣
訄	□
訅	□
訆	□
訇	訇
計	计
訉	□
訊	讯
訋	□
訌	讧
訍	□
討	讨
訏	□
訐	讦
訑	□
訒	讱
訓	训
訔	訔
訕	讪
訖	讫
託	托
託	讬
記	记
訙	□
訛	讹
訜	□
訝	讶
訞	□
訟	讼
訠	□
訡	□
訢	□
訣	诀
訤	□
訥	讷
訦	□
訧	□
訨	□
訩	讻
訪	访
訫	□
訬	□
設	设
訮	□
訯	□
訰	□
許	许
訲	□
訳	译
訴	诉
訵	□
訶	诃
訷	□
訸	□
訹	□
診	诊
註	注
証	□
訽	□
訾	訾
訿	□
詀	□
詁	诂
詂	□
詃	□
詄	□
詅	□
詆	诋
詇	□
詈	詈
詉	□
詊	□
詋	□
詌	□
詍	□
詎	讵
詏	□
詐	诈
詑	□
詒	诒
詓	□
詔	诏
評	评
詖	诐
詗	诇
詘	诎
詙	□
詚	□
詛	诅
詜	□
詝	□
詞	词
詠	咏
詡	诩
詢	询
詣	诣
詤	□
詥	□
試	试
詧	詧
詨	□
詩	诗
詪	□
詫	诧
詬	诟
詭	诡
詮	诠
詯	□
詰	诘
話	话
該	该
詳	详
詴	□
詵	诜
詶	□
詷	□
詸	□
詹	詹
詺	□
詻	□
詼	诙
詽	□
詾	□
詿	诖
誀	□
誁	□
誂	□
誃	□
誄	诔
誅	诛
誆	诓
誇	夸
誈	□
誋	□
誌	志
認	认
誎	□
誏	□
誐	□
誑	诳
誒	诶
誓	誓
誔	□
誕	诞
誖	誖
誗	□
誘	诱
誙	□
誚	诮
誛	□
誜	□
誝	□
語	语
誟	□
誠	诚
誡	诫
誢	□
誣	诬
誤	误
誥	诰
誦	诵
誧	□
誨	诲
誩	□
說	说
誫	□
説	说
読	读
誯	誯
誰	谁
課	课
誳	□
誴	□
誵	□
誶	谇
誷	□
誸	□
誹	诽
誺	□
誻	□
誼	谊
誽	□
誾	訚
調	调
諀	□
諁	□
諂	谄
諃	□
諄	谆
諅	諅
諆	□
談	谈
諈	□
諉	诿
諊	□
請	请
諌	□
諍	诤
諎	□
諏	诹
諐	諐
諑	诼
諒	谅
諓	□
諔	□
諕	□
論	论
諗	谂
諘	□
諙	□
諚	□
諛	谀
諜	谍
諝	谞
諞	谝
諟	□
諠	□
諡	谥
諢	诨
諣	□
諤	谔
諥	□
諦	谛
諧	谐
諨	□
諩	□
諪	□
諫	谏
諬	諬
諭	谕
諮	谘
諯	□
諰	□
諱	讳
諲	□
諳	谙
諴	□
諵	□
諶	谌
諷	讽
諸	诸
諹	□
諺	谚
諻	□
諼	谖
諽	□
諾	诺
諿	□
謀	谋
謁	谒
謂	谓
謄	誊
謅	诌
謆	□
謇	謇
謈	謈
謊	谎
謋	□
謌	□
謍	謍
謎	谜
謏	□
謐	谧
謑	□
謒	□
謓	□
謔	谑
謕	□
謖	谡
謗	谤
謘	□
謙	谦
謚	谥
講	讲
謜	□
謝	谢
謞	□
謟	□
謠	谣
謡	□
謣	□
謤	□
謥	□
謦	謦
謧	□
謨	谟
謩	謩
謪	□
謫	谪
謬	谬
謭	谫
謮	□
謯	□
謰	□
謱	□
謲	□
謳	讴
謴	□
謵	□
謶	□
謷	謷
謸	□
謹	谨
謺	□
謻	□
謼	□
謽	謽
謾	谩
謿	□
譀	譀
譁	哗
譂	□
譃	□
譄	□
譅	□
譆	□
譇	□
譈	□
證	证
譊	□
譋	□
譌	□
譍	譍
譎	谲
譏	讥
譐	□
譑	□
譒	□
譓	□
譔	□
譕	□
譖	谮
譗	□
識	识
譙	谯
譚	谭
譛	□
譜	谱
譝	□
譞	□
譟	□
譠	□
譡	谠
譢	□
譣	□
譤	□
譥	譥
警	警
譧	□
譨	□
譩	□
譪	□
譫	谵
譬	譬
譭	毀
譮	□
譯	译
議	议
譱	譱
譲	□
譳	□
譴	谴
譵	□
譶	譶
護	护
譸	诪
譹	□
譺	□
譻	□
譼	□
譽	誉
譾	□
譿	□
讀	读
讁	□
讂	□
讃	□
讄	□
讅	谉
讆	□
讇	□
讈	□
讉	□
變	变
讋	詟
讌	䜩
讍	□
讎	雠
讏	□
讐	讐
讑	□
讒	谗
讓	让
讔	□
讕	谰
讖	谶
讗	□
讘	□
讙	讙
讚	赞
讛	□
讜	□
讝	□
讞	谳
讟	□
谷	谷
谸	谸
谹	谹
谺	谺
谻	谻
谼	谼
谽	谽
谾	谾
谿	谿
豀	豀
豁	豁
豂	豂
豃	豃
豄	□
豅	□
豆	豆
豇	豇
豈	岂
豉	豉
豊	豊
豋	豋
豌	豌
豍	豍
豎	竖
豏	豏
豐	丰
豑	豑
豒	豒
豓	豓
豔	豔
豕	豕
豖	豖
豗	豗
豘	豘
豙	豙
豚	豚
豛	豛
豜	豜
豝	豝
豞	豞
豟	豟
豠	豠
象	象
豢	豢
豣	豣
豤	豤
豥	豥
豦	豦
豧	豧
豨	豨
豩	豩
豪	豪
豫	豫
豬	猪
豭	豭
豯	豯
豰	豰
豱	豱
豲	豲
豳	豳
豴	豴
豵	□
豶	豮
豷	豷
豸	豸
豹	豹
豺	豺
豻	豻
豼	豼
豽	豽
豾	豾
豿	豿
貀	貀
貁	貁
貂	貂
貃	貃
貄	貄
貅	貅
貆	貆
貇	貇
貈	貈
貉	貉
貊	貊
貋	貋
貌	貌
貍	狸
貎	貎
貏	貏
貐	貐
貑	貑
貒	貒
貓	猫
貔	貔
貕	貕
貖	貖
貗	□
貘	獏
貙	□
貚	□
貛	獾
貜	貜
貝	贝
貞	贞
貟	贠
負	负
財	财
貢	贡
貣	貣
貤	□
貥	□
貦	□
貧	贫
貨	货
販	贩
貪	贪
貫	贯
責	责
貭	□
貮	□
貯	贮
貰	贳
貱	貱
貲	赀
貳	贰
貴	贵
貵	□
貶	贬
買	买
貸	贷
貹	□
貺	贶
費	费
貼	贴
貽	贻
貾	□
貿	贸
賀	贺
賁	贲
賂	赂
賃	赁
賄	贿
賅	赅
賆	□
資	资
賈	贾
賉	□
賊	贼
賋	□
賌	□
賍	□
賎	贱
賏	□
賐	□
賑	赈
賒	赊
賓	宾
賔	賔
賕	赇
賖	□
賗	□
賘	□
賙	赒
賚	赉
賛	□
賜	赐
賝	□
賞	赏
賟	□
賠	赔
賡	赓
賢	贤
賣	卖
賤	贱
賥	□
賦	赋
賧	赕
賨	□
賩	□
質	质
賫	赍
賬	账
賭	赌
賮	□
賯	□
賰	□
賱	□
賲	□
賳	□
賴	赖
賵	赗
賶	□
賷	□
賸	□
賹	□
賺	赚
賻	赙
購	购
賽	赛
賿	□
贀	□
贁	□
贂	□
贃	□
贄	贽
贅	赘
贆	□
贇	赟
贈	赠
贉	□
贊	赞
贋	赝
贍	赡
贎	□
贏	赢
贐	赆
贑	□
贒	□
贓	赃
贔	赑
贕	□
贖	赎
贗	赝
贙	□
贚	□
贛	赣
贜	赃
赤	赤
赥	赥
赦	赦
赧	赧
赨	赨
赩	赩
赫	赫
赬	赪
赭	赭
赮	赮
赯	赯
走	走
赱	赱
赲	赲
赳	赳
赴	赴
起	起
赸	赸
赹	赹
赺	赺
赻	赻
赼	赼
赽	赽
赾	赾
赿	赿
趀	趀
趁	趁
趂	趂
趃	趃
趄	趄
超	超
趆	趆
趇	趇
趈	趈
趉	趉
越	越
趌	趌
趍	趍
趎	趎
趏	趏
趐	趐
趑	趑
趒	趒
趓	趓
趔	趔
趕	赶
趖	趖
趗	趗
趘	趘
趙	赵
趚	趚
趛	趛
趜	趜
趝	趝
趞	趞
趟	趟
趠	趠
趡	趡
趢	趢
趣	趣
趤	趤
趥	趥
趦	趦
趧	趧
趨	趋
趩	趩
趪	趪
趫	□
趬	□
趭	趭
趮	趮
趯	趯
趲	趱
足	足
趴	趴
趵	趵
趶	趶
趷	趷
趹	趹
趺	趺
趻	趻
趼	趼
趽	趽
趾	趾
趿	趿
跀	跀
跁	跁
跂	跂
跅	跅
跆	跆
跇	跇
跈	跈
跉	跉
跊	跊
跋	跋
跌	跌
跍	跍
跎	跎
跏	跏
跐	跐
跑	跑
跒	跒
跓	跓
跔	跔
跕	跕
跖	跖
跗	跗
跘	跘
跙	跙
跚	跚
跛	跛
跜	跜
距	距
跟	跟
跠	跠
跡	迹
跢	跢
跣	跣
跤	跤
跥	跺
跦	跦
跧	跧
跨	跨
跩	跩
跪	跪
跫	跫
跬	跬
跭	跭
跮	跮
路	路
跰	跰
跱	跱
跲	跲
跳	跳
跴	跴
跺	跺
跼	跼
跽	跽
跾	跾
跿	跿
踀	踀
踁	□
踂	踂
踃	踃
踄	踄
踅	踅
踆	踆
踇	踇
踈	踈
踉	踉
踋	踋
踍	踍
踎	踎
踏	踏
踐	践
踑	踑
踒	踒
踓	踓
踔	踔
踕	踕
踖	踖
踗	踗
踘	踘
踙	踙
踚	□
踛	踛
踜	踜
踝	踝
踞	踞
踟	踟
踠	踠
踡	踡
踢	踢
踣	踣
踤	踤
踥	踥
踦	踦
踧	踧
踨	踨
踩	踩
踫	踫
踭	□
踮	踮
踰	踰
踱	踱
踲	踲
踳	踳
踴	踊
踵	踵
踶	踶
踷	踷
踸	踸
踹	踹
踺	踺
踻	□
踼	□
踽	踽
踾	踾
踿	踿
蹀	蹀
蹁	蹁
蹂	蹂
蹃	蹃
蹄	蹄
蹅	蹅
蹆	蹆
蹇	蹇
蹈	蹈
蹉	蹉
蹊	蹊
蹋	蹋
蹌	跄
蹍	蹍
蹎	蹎
蹏	蹏
蹐	蹐
蹓	蹓
蹔	蹔
蹕	跸
蹖	蹖
蹗	蹗
蹘	蹘
蹙	蹙
蹚	蹚
蹛	□
蹜	蹜
蹝	蹝
蹞	□
蹟	蹟
蹠	蹠
蹡	□
蹢	蹢
蹣	蹒
蹤	踪
蹥	□
蹦	蹦
蹧	蹧
蹨	蹨
蹩	蹩
蹪	□
蹫	蹫
蹬	蹬
蹭	蹭
蹮	蹮
蹯	蹯
蹱	蹱
蹲	蹲
蹳	□
蹴	蹴
蹵	蹵
蹶	蹶
蹷	蹷
蹸	蹸
蹹	蹹
蹺	跷
蹻	□
蹼	蹼
蹽	蹽
蹾	蹾
躀	□
躁	躁
躂	跶
躃	躃
躄	躄
躅	躅
躆	躆
躇	躇
躈	躈
躉	趸
躊	踌
躋	跻
躌	躌
躍	跃
躎	□
躐	躐
躑	踯
躒	跞
躓	踬
躔	躔
躕	蹰
躖	躖
躗	□
躘	□
躙	□
躚	跹
躛	躛
躝	□
躞	躞
躟	躟
躠	躠
躡	蹑
躢	□
躣	躣
躤	躤
躥	蹿
躦	躜
躧	□
躨	躨
躩	躩
躪	躏
身	身
躬	躬
躭	躭
躰	躰
躱	躲
躲	躲
躳	躳
躴	躴
躶	躶
躷	躷
躸	躸
躹	躹
躺	躺
躽	躽
躿	躿
軀	躯
軁	□
軂	□
軃	□
軄	□
軆	軆
軇	□
軉	□
車	车
軋	轧
軌	轨
軍	军
軎	□
軏	□
軐	□
軑	轪
軒	轩
軓	□
軔	轫
軕	□
軖	□
軗	□
軘	□
軙	□
軚	□
軛	轭
軜	□
軝	□
軞	□
軟	软
軠	□
軡	□
転	转
軣	□
軤	轷
軥	□
軦	□
軧	□
軨	□
軩	軩
軪	□
軫	轸
軬	□
軭	□
軮	□
軯	□
軰	□
軱	□
軲	轱
軳	□
軴	□
軵	□
軶	□
軷	□
軸	轴
軹	轵
軺	轺
軻	轲
軼	轶
軽	轻
軾	轼
軿	□
輀	□
輁	□
輂	□
較	较
輄	□
輅	辂
輆	□
輇	辁
輈	辀
載	载
輊	轾
輋	□
輌	辆
輍	□
輎	□
輏	□
輐	□
輑	□
輒	辄
輓	□
輔	辅
輕	轻
輖	□
輗	□
輘	□
輙	□
輚	□
輛	辆
輜	辎
輝	辉
輞	辋
輟	辍
輠	□
輡	□
輢	□
輣	□
輤	□
輥	辊
輦	辇
輧	□
輨	□
輩	辈
輪	轮
輫	□
輬	辌
輭	□
輮	□
輯	辑
輰	□
輱	□
輲	□
輳	辏
輴	□
輵	□
輶	□
輷	□
輸	输
輹	□
輺	□
輻	辐
輼	辒
輽	□
輾	辗
輿	舆
轀	辒
轁	□
轂	毂
轃	□
轄	辖
轅	辕
轆	辘
轇	□
轈	□
轉	转
轊	□
轋	□
轍	辙
轎	轿
轏	□
轐	□
轑	□
轒	□
轓	□
轔	辚
轕	□
轖	□
轗	□
轘	□
轙	□
轚	□
轛	□
轜	□
轝	□
轞	□
轟	轰
轠	□
轡	辔
轢	轹
轣	□
轤	轳
轥	□
辛	辛
辜	辜
辝	辝
辟	辟
辠	辠
辡	辡
辢	辢
辣	辣
辤	辤
辥	辥
辦	办
辧	辧
辨	辨
辬	辬
辭	辞
辮	辫
辯	辩
辰	辰
辱	辱
農	农
辳	辳
辴	□
辵	辵
辸	辸
辺	边
辻	辻
辿	辿
迀	迀
迂	迂
迃	迃
迄	迄
迅	迅
迆	迆
迉	迉
迊	迎
迋	迋
迍	迍
迎	迎
迏	迏
近	近
迒	迒
迓	迓
返	返
迕	迕
迖	迖
迗	迗
迠	迠
迡	迡
迢	迢
迣	迣
迤	迤
迥	迥
迦	迦
迧	迧
迨	迨
迪	迪
迫	迫
迬	迬
迭	迭
迮	迮
迯	迯
述	述
迱	迱
迴	回
迵	迵
迷	迷
迸	迸
迺	乃
迻	迻
迼	迼
追	追
迾	迾
迿	迿
退	退
送	送
逃	逃
逄	逄
逅	逅
逆	逆
逇	逇
逈	逈
逋	逋
逌	逌
逍	逍
逎	逎
透	透
逐	逐
逑	逑
逓	逓
途	途
逕	径
逕	迳
逖	逖
逗	逗
逘	逘
這	这
通	通
逛	逛
逜	逜
逝	逝
逞	逞
速	速
造	造
逡	逡
逢	逢
連	连
逤	逤
逥	迴
逨	□
逩	逩
逪	逪
逫	逫
逬	迸
逭	逭
逮	逮
逯	逯
逰	逰
週	周
進	进
逳	逳
逴	逴
逵	逵
逶	逶
逷	逷
逸	逸
逺	远
逼	逼
逽	逽
逾	逾
逿	□
遀	迶
遁	遁
遂	遂
遃	遃
遄	遄
遆	遆
遇	遇
遈	遈
遉	遉
遊	游
運	运
遌	遌
遍	遍
過	过
遏	遏
遐	遐
遑	遑
遒	遒
道	道
達	达
違	违
遘	遘
遙	遥
遚	遚
遛	遛
遜	逊
遝	遝
遞	递
遟	遟
遠	远
遡	遡
遢	遢
遣	遣
遦	□
遧	遧
遨	遨
適	适
遪	□
遫	遫
遬	遬
遭	遭
遮	遮
遯	遯
遰	□
遱	□
遲	迟
遳	遳
遴	遴
遵	遵
遶	绕
遷	迁
選	选
遹	遹
遺	遗
遻	遻
遼	辽
遽	遽
遾	遾
避	避
邀	邀
邁	迈
邂	邂
邃	邃
還	还
邅	邅
邆	邆
邇	迩
邈	邈
邉	邉
邊	边
邋	邋
邌	邌
邍	邍
邎	邎
邏	逻
邐	逦
邑	邑
邒	邒
邔	邔
邕	邕
邖	邖
邗	邗
邘	邘
邙	邙
邚	邚
邛	邛
邞	邞
邟	邟
邠	邠
邡	邡
邢	邢
那	那
邥	邥
邦	邦
邧	邧
邨	邨
邩	邩
邪	邪
邫	邫
邭	邭
邯	邯
邰	邰
邱	邱
邲	邲
邳	邳
邴	邴
邵	邵
邶	邶
邷	邷
邸	邸
邼	邼
邽	邽
邾	邾
邿	邿
郀	郀
郁	郁
郂	郂
郃	郃
郄	郄
郅	郅
郆	郆
郇	郇
郈	郈
郉	郉
郊	郊
郋	郋
郌	郌
郍	郍
郎	郎
郔	郔
郕	郕
郖	郖
郗	郗
郘	□
郙	郙
郚	郚
郛	郛
郜	郜
郝	郝
郞	郞
郟	郏
郠	郠
郡	郡
郢	郢
郣	郣
郤	郤
郥	□
部	部
郩	郩
郪	郪
郫	郫
郬	郬
郭	郭
郯	郯
郰	郰
郱	郱
郲	□
郳	郳
郴	郴
郵	邮
郶	郶
郷	郷
郹	郹
郺	郺
郻	郻
郼	□
都	都
郾	郾
郿	郿
鄀	鄀
鄁	鄁
鄂	鄂
鄃	鄃
鄄	鄄
鄅	鄅
鄆	郓
鄇	鄇
鄈	鄈
鄉	乡
鄊	鄊
鄋	鄋
鄌	鄌
鄍	鄍
鄎	鄎
鄏	鄏
鄐	鄐
鄑	□
鄒	邹
鄓	鄓
鄔	邬
鄕	乡
鄖	郧
鄗	鄗
鄘	鄘
鄙	鄙
鄚	鄚
鄛	鄛
鄜	鄜
鄝	鄝
鄞	鄞
鄟	□
鄠	鄠
鄡	□
鄢	鄢
鄣	鄣
鄤	鄤
鄥	□
鄦	□
鄧	邓
鄨	鄨
鄩	□
鄪	□
鄫	鄫
鄬	□
鄭	郑
鄮	□
鄯	鄯
鄰	邻
鄱	鄱
鄲	郸
鄳	□
鄴	邺
鄵	鄵
鄶	郐
鄷	鄷
鄸	□
鄹	鄹
鄺	邝
鄻	□
鄼	□
鄽	鄽
鄾	鄾
鄿	□
酀	酀
酁	酁
酃	酃
酄	酄
酅	酅
酆	酆
酇	酂
酈	郦
酉	酉
酊	酊
酋	酋
酌	酌
配	配
酎	酎
酏	酏
酐	酐
酑	酑
酒	酒
酓	酓
酔	酔
酕	酕
酖	酖
酗	酗
酘	酘
酙	酙
酚	酚
酞	酞
酟	酟
酠	酠
酡	酡
酢	酢
酣	酣
酤	酤
酥	酥
酧	酧
酨	酨
酩	酩
酪	酪
酫	酫
酬	酬
酭	酭
酮	酮
酯	酯
酰	酰
酲	酲
酳	酳
酴	酴
酵	酵
酶	酶
酷	酷
酸	酸
酹	酹
酺	酺
酻	酻
酼	酼
醀	醀
醁	醁
醂	醂
醃	腌
醄	醄
醅	醅
醆	醆
醇	醇
醈	醈
醉	醉
醊	醊
醋	醋
醌	醌
醍	醍
醎	醎
醏	醏
醐	醐
醑	醑
醒	醒
醓	醓
醔	醔
醕	醕
醖	醖
醗	酦
醘	醘
醙	醙
醚	醚
醛	醛
醜	丑
醝	醝
醞	酝
醟	□
醠	醠
醡	醡
醢	醢
醣	醣
醤	酱
醥	醥
醦	□
醧	□
醨	醨
醩	醩
醪	醪
醫	医
醬	酱
醭	醭
醮	醮
醯	醯
醰	醰
醱	酦
醲	□
醳	醳
醴	醴
醵	醵
醶	□
醷	醷
醸	醸
醹	醹
醺	醺
醻	□
醼	醼
醽	醽
醾	醾
醿	醿
釀	酿
釁	衅
釂	釂
釃	酾
釄	釄
釅	酽
釆	釆
采	采
釈	释
釉	釉
釋	释
里	里
重	重
野	野
量	量
釐	厘
金	金
釒	钅
釓	钆
釔	钇
釕	钌
釖	□
釗	钊
釘	钉
釙	钋
釚	□
釛	□
釜	釜
針	针
釞	□
釟	□
釠	□
釡	釡
釢	□
釣	钓
釤	钐
釥	□
釦	釦
釧	钏
釨	□
釩	钒
釪	□
釫	□
釬	□
釭	釭
釮	□
釯	□
釰	□
釱	□
釲	□
釳	□
釴	□
釵	钗
釶	□
釷	钍
釸	□
釹	钕
釺	钎
釼	□
釽	□
釾	□
釿	□
鈀	钯
鈁	钫
鈂	□
鈃	钘
鈄	钭
鈅	□
鈆	□
鈇	□
鈈	钚
鈉	钠
鈊	□
鈋	□
鈌	□
鈍	钝
鈎	钩
鈏	□
鈐	钤
鈑	钣
鈒	钑
鈓	□
鈔	钞
鈕	钮
鈖	□
鈗	□
鈘	□
鈙	□
鈚	□
鈛	□
鈜	□
鈝	□
鈞	钧
鈟	□
鈠	□
鈡	□
鈢	□
鈣	钙
鈤	□
鈥	钬
鈦	钛
鈧	钪
鈪	□
鈬	铎
鈭	□
鈮	铌
鈯	□
鈰	铈
鈱	□
鈲	□
鈳	钶
鈴	铃
鈵	□
鈶	□
鈷	钴
鈸	钹
鈹	铍
鈺	钰
鈻	□
鈼	□
鈽	钸
鈾	铀
鈿	钿
鉀	钾
鉁	□
鉂	□
鉃	□
鉄	铁
鉅	钜
鉆	□
鉇	□
鉈	铊
鉉	铉
鉊	□
鉋	铇
鉌	□
鉍	铋
鉎	□
鉏	鉏
鉐	□
鉑	铂
鉒	□
鉓	□
鉔	□
鉕	钷
鉖	□
鉗	钳
鉘	□
鉙	□
鉚	铆
鉛	铅
鉜	□
鉝	□
鉞	钺
鉟	□
鉠	□
鉡	□
鉢	钵
鉤	钩
鉥	□
鉦	钲
鉧	□
鉨	□
鉩	□
鉪	□
鉫	□
鉬	钼
鉭	钽
鉮	□
鉯	□
鉰	□
鉱	矿
鉲	□
鉳	□
鉵	□
鉶	铏
鉷	□
鉸	铰
鉹	□
鉺	铒
鉻	铬
鉼	□
鉽	□
鉾	□
鉿	铪
銀	银
銁	□
銂	□
銃	铳
銄	□
銅	铜
銆	□
銇	□
銈	□
銉	□
銊	□
銋	□
銌	□
銍	铚
銎	□
銏	□
銐	銐
銑	铣
銒	□
銓	铨
銔	□
銕	□
銖	铢
銗	□
銘	铭
銙	□
銚	铫
銛	铦
銜	衔
銝	□
銞	□
銟	□
銠	铑
銡	□
銢	□
銣	铷
銤	□
銥	铱
銦	铟
銧	□
銨	铵
銩	铥
銪	铕
銫	铯
銬	铐
銭	钱
銰	□
銱	铞
銲	□
銳	锐
銴	□
銵	□
銶	□
銷	销
銸	□
銹	锈
銺	□
銻	锑
銼	锉
銽	□
銾	□
銿	□
鋀	□
鋁	铝
鋂	□
鋃	锒
鋄	□
鋅	锌
鋆	□
鋇	钡
鋈	□
鋉	□
鋊	□
鋋	□
鋌	铤
鋍	□
鋎	□
鋏	铗
鋐	□
鋑	□
鋒	锋
鋓	□
鋔	□
鋕	□
鋖	□
鋗	□
鋘	□
鋙	铻
鋚	□
鋛	□
鋜	□
鋝	锊
鋞	□
鋟	锓
鋠	□
鋡	□
鋢	□
鋣	铘
鋤	锄
鋥	锃
鋦	锔
鋧	□
鋨	锇
鋩	铓
鋪	铺
鋫	□
鋬	□
鋭	锐
鋮	铖
鋯	锆
鋰	锂
鋱	铽
鋳	铸
鋵	□
鋶	锍
鋷	□
鋸	锯
鋹	□
鋺	□
鋻	鋻
鋼	钢
鋽	□
鋾	□
鋿	□
錀	□
錁	锞
錂	□
錃	錃
錄	录
錅	錅
錆	锖
錇	锫
錈	锩
錉	□
錊	□
錋	□
錌	□
錍	□
錎	□
錏	铔
錐	锥
錑	□
錒	锕
錓	□
錔	□
錕	锟
錖	錖
錗	□
錘	锤
錙	锱
錚	铮
錛	锛
錜	□
錝	□
錞	□
錟	锬
錠	锭
錡	锜
錢	钱
錣	□
錤	□
錥	□
錦	锦
錧	□
錨	锚
錩	锠
錪	□
錫	锡
錬	□
錭	□
錮	锢
錯	错
錰	□
錱	□
録	录
錳	锰
錴	□
錵	□
錶	表
錷	□
錸	铼
錹	□
錼	□
錽	□
鍀	锝
鍁	锨
鍃	锪
鍄	□
鍆	钔
鍇	锴
鍈	锳
鍉	□
鍊	炼
鍋	锅
鍌	□
鍍	镀
鍎	□
鍏	□
鍐	□
鍑	□
鍒	□
鍓	□
鍔	锷
鍕	□
鍖	□
鍗	□
鍘	铡
鍙	鍙
鍚	钖
鍛	锻
鍜	□
鍝	□
鍞	□
鍟	□
鍠	锽
鍡	□
鍢	□
鍣	□
鍤	锸
鍥	锲
鍦	□
鍧	□
鍨	□
鍩	锘
鍪	□
鍫	□
鍬	锹
鍭	□
鍮	□
鍯	□
鍰	锾
鍱	□
鍲	□
鍳	鍳
鍴	□
鍵	键
鍶	锶
鍷	□
鍸	□
鍹	□
鍺	□
鍻	□
鍼	□
鍽	□
鍾	钟
鍾	锺
鍿	□
鎀	□
鎁	□
鎂	镁
鎃	□
鎄	锿
鎅	□
鎇	镅
鎈	□
鎉	□
鎊	镑
鎋	□
鎌	□
鎍	□
鎎	□
鎏	□
鎐	□
鎑	□
鎒	□
鎓	□
鎔	镕
鎕	□
鎖	锁
鎗	枪
鎘	镉
鎙	□
鎚	锤
鎛	镈
鎜	□
鎝	□
鎞	□
鎟	□
鎠	□
鎡	镃
鎢	钨
鎣	蓥
鎤	□
鎥	□
鎦	镏
鎧	铠
鎨	□
鎩	铩
鎪	锼
鎫	□
鎬	镐
鎭	镇
鎮	镇
鎯	□
鎰	镒
鎱	□
鎲	镋
鎳	镍
鎴	□
鎵	镓
鎶	□
鎷	□
鎸	镌
鎻	□
鎿	镎
鏀	□
鏁	□
鏂	□
鏃	镞
鏄	□
鏅	□
鏆	□
鏇	镟
鏈	链
鏉	□
鏊	鏊
鏋	□
鏌	镆
鏍	镙
鏎	□
鏏	□
鏐	镠
鏑	镝
鏒	□
鏓	□
鏔	□
鏕	□
鏖	鏖
鏗	铿
鏘	锵
鏙	□
鏚	□
鏛	□
鏜	镗
鏝	镘
鏞	镛
鏟	铲
鏠	□
鏡	镜
鏢	镖
鏣	□
鏤	镂
鏥	□
鏦	□
鏧	□
鏨	錾
鏩	□
鏪	□
鏫	□
鏬	□
鏭	□
鏮	□
鏰	镚
鏳	□
鏴	□
鏵	铧
鏶	□
鏷	镤
鏸	□
鏹	镪
鏺	□
鏻	□
鏼	□
鏽	锈
鏾	□
鏿	□
鐀	□
鐁	□
鐂	□
鐃	铙
鐄	□
鐅	□
鐆	□
鐇	□
鐈	□
鐉	□
鐊	□
鐋	铴
鐌	□
鐍	□
鐎	□
鐏	□
鐐	镣
鐑	□
鐒	铹
鐓	镦
鐔	镡
鐕	□
鐖	□
鐗	□
鐘	钟
鐙	镫
鐚	□
鐛	□
鐜	鐜
鐝	镢
鐞	□
鐟	□
鐠	镨
鐡	□
鐤	□
鐥	□
鐦	锎
鐧	锏
鐨	镄
鐩	□
鐪	□
鐫	镌
鐬	□
鐭	□
鐮	镰
鐯	□
鐰	□
鐱	□
鐲	镯
鐳	镭
鐴	□
鐵	铁
鐶	镮
鐷	□
鐸	铎
鐹	□
鐺	铛
鐻	□
鐼	□
鐽	□
鐾	鐾
鐿	镱
鑀	□
鑁	□
鑂	□
鑃	□
鑄	铸
鑅	□
鑆	□
鑇	□
鑈	□
鑉	□
鑊	镬
鑋	□
鑌	镔
鑍	□
鑎	□
鑏	□
鑐	□
鑑	鉴
鑒	鉴
鑔	镲
鑕	锧
鑖	□
鑗	□
鑘	□
鑙	□
鑚	钻
鑛	矿
鑜	□
鑝	□
鑞	镴
鑟	□
鑠	铄
鑡	□
鑢	□
鑣	镳
鑤	□
鑥	镥
鑨	□
鑩	□
鑪	□
鑫	鑫
鑬	□
鑭	镧
鑮	□
鑯	□
鑰	钥
鑱	镵
鑲	镶
鑳	□
鑴	□
鑵	□
鑶	□
鑷	镊
鑸	□
鑹	镩
鑺	□
鑻	□
鑼	锣
鑽	钻
鑾	銮
鑿	凿
钀	□
钁	□
钂	镋
钃	□
钄	□
镸	镸
镹	镹
镺	镺
镻	镻
镼	镼
镽	镽
镾	□
門	门
閁	□
閂	闩
閃	闪
閄	□
閅	□
閆	闫
閇	□
閈	闬
閉	闭
開	开
閌	闶
閍	□
閎	闳
閏	闰
閐	□
閑	闲
閒	闲
間	间
閔	闵
閕	□
閗	斗
閘	闸
閙	闹
閛	□
閜	□
閝	□
閞	□
閟	□
閠	□
閡	阂
関	关
閣	阁
閤	合
閥	阀
閦	□
閧	□
閨	闺
閩	闽
閫	阃
閬	阆
閭	闾
閮	□
閯	□
閰	□
閱	阅
閲	阅
閳	□
閴	□
閵	□
閶	阊
閷	□
閸	□
閹	阉
閺	□
閻	阎
閼	阏
閽	阍
閾	阈
閿	阌
闀	□
闁	□
闂	□
闃	阒
闄	□
闅	□
闆	板
闇	□
闈	闱
闉	□
闊	阔
闋	阕
闌	阑
闍	阇
闐	阗
闑	□
闒	阘
闓	闿
闔	阖
闕	阙
闖	闯
闗	关
闘	斗
闙	□
闚	□
闛	□
關	关
闝	□
闞	阚
闟	□
闠	阓
闡	阐
闢	辟
闣	□
闤	阛
闥	闼
闦	□
阞	阞
阠	阠
阡	阡
阢	阢
阣	阣
阤	阤
阥	阥
阦	阦
阧	阧
阨	阨
阩	阩
阪	阪
阫	阫
阬	阬
阭	阭
阮	阮
阯	阯
阰	阰
阱	阱
防	防
阷	阷
阸	阸
阹	阹
阺	阺
阻	阻
阼	阼
阽	阽
阾	阾
阿	阿
陀	陀
陁	陁
陂	陂
陃	陃
附	附
陊	陊
陋	陋
陌	陌
降	降
陎	陎
陏	陏
限	限
陑	陑
陒	陒
陓	陓
陔	陔
陖	陖
陗	陗
陘	陉
陙	陙
陚	陚
陛	陛
陜	陕
陝	陕
陞	升
陟	陟
陠	陠
陡	陡
院	院
陣	阵
除	除
陥	陷
陧	陧
陪	陪
陫	陫
陬	陬
陭	陭
陮	陮
陯	□
陰	阴
陱	陱
陲	陲
陳	陈
陴	陴
陵	陵
陶	陶
陷	陷
陸	陆
険	险
陻	陻
陼	陼
陽	阳
陾	陾
陿	□
隀	隀
隁	隁
隂	隂
隃	隃
隄	隄
隅	隅
隆	隆
隇	隇
隈	隈
隉	隉
隊	队
隋	隋
隌	隌
隍	隍
階	阶
隑	□
隒	隒
隓	隓
隔	隔
隕	陨
隖	隖
隗	隗
隘	隘
隙	隙
隚	隚
際	际
障	障
隝	□
隞	隞
隟	隟
隠	隐
隢	□
隣	隣
隤	隤
隥	隥
隦	隦
隧	隧
隨	随
隩	隩
險	险
隫	□
隬	□
隭	隭
隮	□
隯	□
隰	□
隱	隐
隲	□
隳	隳
隴	陇
隵	□
隸	隶
隹	隹
隺	隺
隻	只
隼	隼
隽	隽
隿	隿
雀	雀
雁	雁
雂	雂
雃	雃
雄	雄
雅	雅
集	集
雇	雇
雈	萑
雉	雉
雊	雊
雋	隽
雌	雌
雍	雍
雎	雎
雐	雐
雑	杂
雒	雒
雓	雓
雔	雔
雕	雕
雖	虽
雗	雗
雘	雘
雙	双
雚	雚
雛	雏
雜	杂
雝	雝
雞	鸡
雟	雟
雡	雡
離	离
難	难
雤	雤
雥	雥
雦	雦
雧	雧
雨	雨
雩	雩
雪	雪
雫	雫
雬	雬
雭	雭
雮	雮
雯	雯
雰	雰
雱	雱
雲	云
雴	雴
雵	雵
零	零
雷	雷
雸	雸
雹	雹
雺	雺
電	电
雼	雼
雽	雽
雿	雿
需	需
霂	霂
霃	霃
霄	霄
霅	霅
霆	霆
震	震
霈	霈
霉	霉
霊	霊
霋	霋
霌	霌
霍	霍
霎	霎
霏	霏
霐	霐
霑	霑
霒	霒
霓	霓
霔	霔
霕	霕
霖	霖
霘	霘
霙	霙
霚	霚
霛	霛
霜	霜
霝	霝
霞	霞
霟	霟
霠	霠
霢	霡
霣	□
霤	霤
霥	霥
霦	霦
霧	雾
霨	霨
霩	霩
霪	霪
霫	霫
霬	霬
霮	霮
霯	霯
霰	霰
霱	霱
露	露
霳	霳
霴	□
霵	霵
霶	霶
霷	霷
霸	霸
霹	霹
霺	霺
霼	霼
霽	霁
霾	霾
霿	霿
靀	靀
靁	靁
靂	雳
靃	靃
靄	霭
靅	□
靆	叇
靇	□
靈	灵
靉	叆
靊	靊
靋	□
靌	□
靎	□
靏	□
靐	靐
靑	青
青	青
靕	靕
靖	靖
靗	靗
靘	靘
靚	靓
靛	靛
靜	静
靝	靔
非	非
靟	靟
靠	靠
靡	靡
面	面
靣	靣
靤	靤
靦	腼
靧	□
靨	靥
革	革
靪	靪
靫	靫
靬	靬
靭	靭
靮	靮
靯	靯
靰	靰
靱	靱
靲	靲
靳	靳
靴	靴
靵	靵
靶	靶
靷	靷
靸	靸
靹	靹
靺	靺
靻	靻
靼	靼
靽	靽
靾	靾
靿	靿
鞀	鞀
鞁	鞁
鞂	鞂
鞃	鞃
鞄	鞄
鞅	鞅
鞇	鞇
鞈	鞈
鞉	鞉
鞊	鞊
鞋	鞋
鞌	鞌
鞍	鞍
鞎	鞎
鞏	巩
鞓	鞓
鞔	鞔
鞕	鞕
鞖	鞖
鞗	鞗
鞘	鞘
鞙	鞙
鞚	鞚
鞛	鞛
鞜	鞜
鞝	鞝
鞞	鞞
鞟	鞟
鞠	鞠
鞡	鞡
鞢	鞢
鞣	鞣
鞤	鞤
鞥	鞥
鞦	秋
鞧	鞧
鞨	鞨
鞩	鞩
鞪	鞪
鞫	鞫
鞬	鞬
鞭	鞭
鞮	鞮
鞱	鞱
鞲	鞲
鞳	鞳
鞴	鞴
鞵	鞵
鞶	鞶
鞷	鞷
鞸	□
鞹	鞹
鞻	□
鞼	□
鞽	鞒
鞾	□
鞿	□
韀	韀
韁	缰
韂	韂
韃	鞑
韄	韄
韅	□
韆	千
韇	□
韈	韈
韉	鞯
韊	□
韋	韦
韌	韧
韍	韨
韎	□
韏	□
韐	□
韑	□
韒	□
韓	韩
韔	□
韖	□
韗	□
韘	□
韙	韪
韚	□
韛	□
韜	韬
韝	韝
韞	韫
韠	□
韡	□
韢	□
韣	□
韤	□
韥	□
韭	韭
韮	韮
韯	韯
韰	韰
韱	韱
韲	齑
音	音
韴	韴
韶	韶
韷	韷
韸	韸
韹	韹
韺	韺
韻	韵
韼	韼
韽	韽
韾	韾
響	响
頀	頀
頁	页
頂	顶
頃	顷
頄	□
項	项
順	顺
頇	顸
須	须
頉	□
頊	顼
頋	顾
頌	颂
頍	□
頎	颀
頏	颃
預	预
頑	顽
頒	颁
頓	顿
頔	□
頕	□
頖	□
頗	颇
領	领
頙	頙
頚	□
頛	□
頜	颌
頝	□
頞	□
頟	□
頠	□
頡	颉
頢	□
頣	□
頤	颐
頥	□
頦	颏
頧	□
頨	□
頩	□
頪	□
頫	頫
頬	颊
頭	头
頮	颒
頯	□
頰	颊
頱	□
頲	颋
頳	□
頴	颕
頵	□
頶	頶
頷	颔
頸	颈
頹	颓
頺	□
頻	频
頼	□
頽	颓
頾	□
頿	□
顀	□
顁	□
顂	□
顃	□
顄	□
顅	□
顆	颗
顇	顇
顈	□
顉	□
顊	□
顋	□
題	题
額	额
顎	颚
顏	颜
顐	□
顑	□
顒	颙
顓	颛
顔	颜
顕	□
顖	囟
顗	□
願	愿
顙	颡
顚	颠
顛	颠
顜	□
顝	□
類	类
顟	□
顠	□
顡	□
顢	颟
顣	□
顤	□
顥	颢
顦	□
顧	顾
顨	□
顩	□
顪	□
顫	颤
顬	颥
顭	□
顮	□
顯	显
顰	颦
顱	颅
顲	□
顳	颞
顴	颧
風	风
颩	□
颫	□
颬	□
颭	飐
颮	飑
颯	飒
颰	□
颱	台
颲	□
颳	刮
颴	□
颵	□
颶	飓
颷	□
颸	飔
颹	□
颺	飏
颻	飖
颼	飕
颽	□
颾	□
颿	□
飀	飗
飁	□
飂	□
飃	□
飄	飘
飅	□
飆	飙
飇	飚
飈	□
飉	□
飋	□
飌	□
飛	飞
飜	飜
食	食
飠	饣
飡	飡
飢	饥
飣	饤
飤	□
飥	饦
飦	□
飧	□
飩	饨
飪	饪
飫	饫
飬	飬
飭	饬
飮	□
飯	饭
飰	□
飱	□
飲	饮
飳	□
飴	饴
飵	□
飶	□
飷	□
飸	飸
飹	□
飺	飺
飻	□
飼	饲
飽	饱
飾	饰
飿	饳
餀	餀
餁	□
餂	□
餃	饺
餄	饸
餅	饼
餆	□
餇	□
餈	餈
餉	饷
養	养
餋	□
餌	饵
餎	饹
餏	饻
餐	餐
餑	饽
餒	馁
餓	饿
餔	□
餕	馂
餖	饾
餗	□
餘	余
餘	馀
餙	□
餚	肴
餛	馄
餜	馃
餝	□
餞	饯
餟	□
餠	饼
餡	馅
餢	□
餣	□
餤	□
餥	餥
餦	□
餧	□
館	馆
餩	□
餪	□
餫	□
餬	糊
餭	□
餮	餮
餯	□
餰	□
餱	□
餲	□
餳	饧
餴	□
餵	喂
餶	馉
餷	馇
餸	□
餹	□
餺	馎
餻	糕
餼	饩
餽	□
餾	馏
餿	馊
饀	□
饁	馌
饂	□
饃	馍
饄	□
饅	馒
饆	□
饇	□
饈	馐
饉	馑
饊	馓
饋	馈
饌	馔
饍	□
饎	□
饏	饏
饐	□
饑	饥
饒	饶
饓	□
饔	□
饕	饕
饖	□
饗	飨
饘	□
饙	□
饚	饚
饛	□
饜	餍
饝	□
饞	馋
饟	□
饠	□
饡	□
饢	馕
首	首
馗	馗
馘	馘
香	香
馚	馚
馛	馛
馜	馜
馝	馝
馞	馞
馟	馟
馠	馠
馡	馡
馢	□
馣	馣
馤	馤
馥	馥
馦	馦
馧	馧
馨	馨
馩	□
馪	□
馫	馫
馭	驭
馮	冯
馯	馯
馰	□
馱	驮
馲	□
馳	驰
馴	驯
馵	□
馶	□
馷	□
馸	□
馹	驲
馺	□
馻	□
馼	□
馽	□
馾	馾
馿	□
駀	□
駁	驳
駂	□
駃	□
駄	□
駅	□
駆	驱
駈	□
駉	□
駊	□
駋	□
駌	□
駍	□
駎	□
駏	□
駐	驻
駑	驽
駒	驹
駓	□
駔	驵
駕	驾
駖	□
駗	□
駘	骀
駙	驸
駚	□
駛	驶
駜	□
駝	驼
駞	□
駟	驷
駠	□
駡	骂
駢	骈
駣	□
駤	□
駥	□
駦	□
駧	□
駨	□
駩	□
駪	□
駫	□
駬	□
駭	骇
駮	□
駰	骃
駱	骆
駳	□
駴	□
駵	□
駶	□
駷	□
駸	骎
駹	□
駺	□
駻	□
駼	□
駽	□
駾	□
駿	骏
騀	□
騁	骋
騂	骍
騃	□
騄	□
騅	骓
騆	□
騇	□
騈	骈
騉	□
騊	□
騋	□
騌	骔
騍	骒
騎	骑
騏	骐
騐	□
騒	□
験	验
騔	□
騕	□
騖	骛
騗	□
騘	□
騙	骗
騚	□
騜	□
騝	□
騞	□
騟	□
騠	□
騡	□
騢	□
騣	□
騤	骙
騥	□
騦	□
騧	□
騨	□
騩	□
騪	□
騫	骞
騬	□
騭	骘
騮	骝
騯	□
騰	腾
騱	□
騲	□
騴	□
騵	□
騶	驺
騷	骚
騸	骟
騹	□
騺	□
騻	□
騼	□
騽	□
騾	骡
騿	□
驀	蓦
驁	骜
驂	骖
驃	骠
驄	骢
驅	驱
驆	□
驇	□
驈	□
驉	□
驊	骅
驋	□
驌	骕
驍	骁
驎	□
驏	骣
驐	□
驑	□
驒	□
驓	□
驔	□
驕	骄
驖	□
驗	验
驘	□
驙	□
驚	惊
驛	驿
驜	□
驝	□
驞	□
驟	骤
驠	□
驡	□
驢	驴
驣	□
驤	骧
驥	骥
驦	骦
驧	□
驨	□
驩	□
驪	骊
驫	骉
骩	骩
骪	骪
骫	骫
骬	骬
骭	骭
骮	骮
骯	肮
骰	骰
骱	骱
骲	骲
骳	骳
骴	骴
骵	骵
骶	骶
骷	骷
骸	骸
骹	骹
骺	骺
骻	骻
骼	骼
骽	骽
骾	骾
骿	骿
髀	髀
髁	髁
髂	髂
髃	髃
髄	髄
髆	髆
髇	髇
髈	髈
髉	髉
髊	髊
髍	髍
髎	髎
髏	髅
髐	□
髑	□
髒	脏
髓	髓
體	体
髕	髌
髖	髋
髗	□
高	高
髙	髙
髚	髚
髛	髛
髜	髜
髝	□
髞	髞
髟	髟
髠	髠
髡	髡
髢	髢
髣	髣
髤	髤
髥	髥
髦	髦
髧	髧
髨	髨
髩	髩
髪	髪
髫	髫
髬	髬
髭	髭
髮	发
髯	髯
髰	髰
髱	髱
髲	髲
髳	髳
髴	髴
髵	髵
髶	髶
髷	髷
髹	髹
髺	髺
髻	髻
髼	髼
髽	髽
髾	髾
髿	髿
鬀	鬀
鬁	鬁
鬂	鬂
鬃	鬃
鬄	鬄
鬅	鬅
鬆	松
鬇	鬇
鬈	鬈
鬉	鬉
鬊	鬊
鬋	鬋
鬌	鬌
鬍	胡
鬎	鬎
鬏	鬏
鬐	鬐
鬑	鬑
鬒	鬒
鬔	鬔
鬕	鬕
鬖	鬖
鬗	□
鬘	鬘
鬙	鬙
鬚	须
鬛	鬛
鬜	□
鬝	□
鬞	□
鬟	鬟
鬠	□
鬡	□
鬢	鬓
鬣	鬣
鬤	鬤
鬥	斗
鬦	斗
鬧	闹
鬨	哄
鬩	阋
鬪	斗
鬫	鬫
鬬	斗
鬭	斗
鬮	阄
鬯	鬯
鬰	鬰
鬱	郁
鬲	鬲
鬳	鬳
鬴	鬴
鬵	鬵
鬷	鬷
鬸	鬸
鬹	鬶
鬺	鬺
鬻	鬻
鬼	鬼
鬽	鬽
鬾	鬾
鬿	鬿
魀	魀
魁	魁
魂	魂
魃	魃
魄	魄
魅	魅
魆	魆
魈	魈
魊	魊
魋	魋
魌	魌
魍	魍
魎	魉
魏	魏
魐	魐
魑	魑
魒	魒
魓	□
魔	魔
魕	□
魖	魖
魗	□
魘	魇
魙	魙
魚	鱼
魛	鱽
魜	□
魝	□
魟	□
魠	□
魡	□
魢	鱾
魣	□
魤	□
魥	□
魦	□
魧	□
魨	鲀
魩	□
魪	□
魫	□
魬	□
魭	□
魮	□
魯	鲁
魰	□
魱	□
魲	□
魳	□
魴	鲂
魵	□
魶	□
魷	鱿
魺	鲄
魻	□
魼	□
魽	□
魾	□
魿	□
鮀	□
鮁	鲅
鮂	□
鮃	鲆
鮄	□
鮅	□
鮆	□
鮇	□
鮈	□
鮉	□
鮊	鲌
鮋	鲉
鮌	□
鮍	鲏
鮎	鲇
鮏	□
鮐	鲐
鮑	鲍
鮒	鲋
鮓	鲊
鮔	□
鮕	□
鮙	□
鮚	鲒
鮛	□
鮜	鲘
鮝	鲞
鮞	鲕
鮟	□
鮠	□
鮡	□
鮢	□
鮣	□
鮤	□
鮥	□
鮦	鲖
鮧	□
鮨	□
鮩	□
鮪	鲔
鮫	鲛
鮬	□
鮭	鲑
鮮	鲜
鮯	□
鮰	□
鮳	鲓
鮵	□
鮶	鲪
鮷	□
鮸	□
鮹	□
鮺	鲝
鮻	□
鮼	□
鮽	□
鮾	□
鮿	□
鯀	鲧
鯁	鲠
鯃	□
鯄	□
鯅	□
鯆	□
鯇	鲩
鯈	□
鯉	鲤
鯊	鲨
鯋	□
鯌	□
鯍	□
鯒	鲬
鯓	□
鯔	鲻
鯕	鲯
鯖	鲭
鯗	□
鯘	□
鯙	□
鯚	□
鯛	鲷
鯜	□
鯝	鲴
鯞	□
鯟	□
鯠	□
鯡	鲱
鯢	鲵
鯣	□
鯤	鲲
鯥	□
鯦	□
鯧	鲳
鯨	鲸
鯩	□
鯪	鲮
鯫	鲰
鯬	□
鯭	□
鯮	□
鯯	□
鯰	鲶
鯴	鲺
鯵	鲹
鯶	□
鯷	鳀
鯸	□
鯹	□
鯺	□
鯻	□
鯼	□
鯽	鲫
鯾	□
鯿	鳊
鰀	□
鰁	鳈
鰂	鲗
鰃	鳂
鰄	□
鰅	□
鰆	□
鰇	□
鰈	鲽
鰉	鳇
鰊	□
鰋	□
鰌	□
鰍	鳅
鰎	□
鰏	鲾
鰐	鳄
鰑	□
鰒	鳆
鰓	鳃
鰔	□
鰕	□
鰖	□
鰗	□
鰙	□
鰛	鳁
鰜	鳒
鰝	□
鰞	□
鰟	鳑
鰠	鳋
鰡	□
鰢	□
鰣	鲥
鰤	□
鰥	鳏
鰧	□
鰨	鳎
鰩	鳐
鰪	□
鰫	□
鰬	□
鰭	鳍
鰮	鳁
鰯	□
鰱	鲢
鰲	鳌
鰳	鳓
鰴	□
鰵	鳘
鰶	□
鰷	鲦
鰸	□
鰹	鲣
鰺	□
鰻	鳗
鰼	鳛
鰽	□
鰾	鳔
鰿	□
鱀	□
鱁	□
鱂	鳉
鱃	□
鱄	□
鱅	鳙
鱆	□
鱇	□
鱈	鳕
鱉	鳖
鱊	□
鱋	□
鱌	□
鱍	□
鱎	□
鱏	□
鱐	□
鱑	□
鱒	鳟
鱓	□
鱔	鳝
鱕	□
鱖	鳜
鱗	鳞
鱘	鲟
鱙	□
鱚	□
鱝	鲼
鱞	□
鱟	鲎
鱠	鲙
鱡	□
鱢	□
鱣	鳣
鱤	鳡
鱥	□
鱦	□
鱧	鳢
鱨	鲿
鱬	□
鱭	鲚
鱮	□
鱯	鳠
鱱	□
鱲	□
鱳	□
鱴	□
鱵	□
鱶	□
鱷	鳄
鱸	鲈
鱹	□
鱺	鲡
鱻	鲜
鳥	鸟
鳦	□
鳧	凫
鳨	□
鳩	鸠
鳪	鳪
鳫	□
鳬	凫
鳭	鳭
鳮	鸡
鳯	凤
鳱	□
鳲	鸤
鳳	凤
鳴	鸣
鳵	□
鳶	鸢
鳷	□
鳸	□
鳹	□
鳺	□
鳻	□
鳼	□
鳽	□
鳾	□
鳿	□
鴀	□
鴁	□
鴂	□
鴃	□
鴄	□
鴅	□
鴆	鸩
鴇	鸨
鴈	□
鴉	鸦
鴊	□
鴋	□
鴌	凤
鴍	□
鴎	鸥
鴏	鴏
鴐	□
鴑	□
鴒	鸰
鴓	□
鴔	□
鴕	鸵
鴖	□
鴗	□
鴘	□
鴙	□
鴚	□
鴛	鸳
鴜	□
鴝	鸲
鴞	鸮
鴟	鸱
鴠	鴠
鴡	□
鴢	□
鴣	鸪
鴤	□
鴥	□
鴦	鸯
鴧	□
鴨	鸭
鴩	□
鴪	□
鴬	莺
鴭	□
鴮	□
鴯	鸸
鴰	鸹
鴱	□
鴲	□
鴳	□
鴴	鸻
鴵	□
鴶	□
鴷	□
鴸	□
鴹	□
鴺	□
鴻	鸿
鴼	□
鴽	□
鴾	□
鴿	鸽
鵀	□
鵁	□
鵂	鸺
鵃	鸼
鵄	□
鵅	□
鵉	鸾
鵊	□
鵋	□
鵌	□
鵍	□
鵎	□
鵏	□
鵐	鹀
鵑	鹃
鵒	鹆
鵓	鹁
鵔	□
鵕	□
鵖	□
鵗	□
鵘	□
鵙	□
鵚	□
鵛	□
鵜	鹈
鵝	鹅
鵞	鹅
鵟	□
鵠	鹄
鵡	鹉
鵢	□
鵣	□
鵦	□
鵧	□
鵨	□
鵩	□
鵪	鹌
鵫	□
鵬	鹏
鵭	□
鵮	鹐
鵯	鹎
鵰	雕
鵱	□
鵲	鹊
鵳	□
鵴	□
鵵	□
鵶	□
鵷	鹓
鵸	□
鵹	□
鵺	□
鵻	□
鵼	□
鵽	□
鵾	鹍
鵿	□
鶀	□
鶁	□
鶂	□
鶃	□
鶄	□
鶅	□
鶆	□
鶇	鸫
鶈	□
鶉	鹑
鶊	鹒
鶋	□
鶌	□
鶏	鸡
鶐	□
鶒	□
鶓	鹋
鶔	□
鶕	□
鶖	鹙
鶗	□
鶘	鹕
鶙	□
鶚	鹗
鶛	□
鶜	□
鶝	□
鶞	□
鶟	□
鶠	□
鶡	鹖
鶢	□
鶣	□
鶤	□
鶥	鹛
鶦	鹕
鶧	□
鶨	□
鶩	鹜
鶪	□
鶬	鸧
鶭	□
鶮	□
鶯	莺
鶰	□
鶱	□
鶲	鹟
鶳	□
鶴	鹤
鶵	雏
鶶	□
鶷	□
鶸	□
鶹	鹠
鶺	鹡
鶻	鹘
鶼	鹣
鶽	□
鶾	□
鶿	□
鷀	鹚
鷁	鹢
鷂	鹞
鷃	□
鷄	鸡
鷅	□
鷆	□
鷇	□
鷈	□
鷉	□
鷊	鹝
鷋	□
鷌	□
鷍	□
鷎	鷎
鷏	□
鷐	鷐
鷑	□
鷒	□
鷓	鹧
鷔	□
鷕	□
鷖	鹥
鷗	鸥
鷘	□
鷙	鸷
鷚	鹨
鷛	□
鷜	□
鷝	□
鷞	□
鷟	□
鷠	□
鷡	□
鷢	□
鷣	□
鷤	□
鷥	鸶
鷦	鹪
鷧	□
鷨	□
鷩	□
鷪	□
鷫	鹔
鷬	□
鷭	□
鷮	□
鷯	鹩
鷰	□
鷱	□
鷲	鹫
鷳	鹇
鷴	鹇
鷵	□
鷶	□
鷷	□
鷸	鹬
鷹	鹰
鷺	鹭
鷻	□
鷼	□
鷽	鸴
鷾	□
鷿	□
鸀	□
鸁	□
鸂	□
鸃	□
鸄	□
鸅	□
鸆	□
鸇	鹯
鸈	□
鸉	□
鸊	□
鸋	□
鸌	鹱
鸍	□
鸎	□
鸏	鹲
鸐	□
鸑	□
鸒	□
鸓	□
鸔	□
鸕	鸬
鸖	□
鸗	□
鸘	鹴
鸙	□
鸚	鹦
鸛	鹳
鸜	□
鸝	鹂
鸞	鸾
鹵	卤
鹶	□
鹷	□
鹸	硷
鹹	咸
鹺	鹾
鹻	□
鹼	硷
鹽	盐
鹿	鹿
麀	麀
麁	麁
麂	麂
麃	麃
麄	麄
麅	麅
麆	麆
麇	麇
麈	麈
麉	麉
麊	麊
麋	麋
麌	麌
麍	麍
麎	麎
麏	麏
麐	麐
麑	麑
麒	麒
麓	麓
麔	麔
麕	麕
麖	麖
麗	丽
麘	麘
麙	麙
麚	麚
麛	麛
麜	麜
麝	麝
麞	麞
麟	麟
麠	麠
麡	□
麢	麢
麣	麣
麤	麤
麥	麦
麧	麧
麨	麨
麩	麸
麪	面
麫	麫
麬	□
麭	□
麮	□
麯	曲
麰	□
麱	□
麲	麲
麳	□
麴	曲
麴	麹
麵	面
麵	麺
麷	□
麻	麻
麼	么
麽	么
麾	麾
黀	黀
黁	黁
黂	□
黃	黄
黅	黅
黆	黆
黇	黇
黈	黈
黊	黊
黋	黋
黌	黉
黍	黍
黎	黎
黏	黏
黐	黐
黑	黑
黒	黑
黓	黓
黔	黔
黕	黕
黖	黖
黗	黗
默	默
黙	黙
黚	黚
黛	黛
黜	黜
黝	黝
點	点
黟	黟
黠	黠
黢	黢
黣	黣
黤	黤
黥	黥
黦	黦
黧	黧
黨	党
黫	黫
黬	黬
黭	黭
黮	黮
黯	黯
黰	黰
黱	黱
黲	黪
黳	黳
黴	霉
黵	黵
黶	黡
黷	黩
黸	□
黹	黹
黺	黺
黻	黻
黼	黼
黽	黾
黿	鼋
鼀	鼀
鼁	□
鼂	鼌
鼃	鼃
鼄	鼄
鼅	鼅
鼆	鼆
鼇	鼇
鼈	鼈
鼉	鼍
鼊	鼊
鼎	鼎
鼏	鼏
鼐	鼐
鼑	鼑
鼒	鼒
鼓	鼓
鼔	鼔
鼕	鼕
鼖	鼖
鼗	鼗
鼘	□
鼙	鼙
鼚	□
鼛	鼛
鼜	鼜
鼝	鼝
鼞	鼞
鼟	鼟
鼠	鼠
鼡	鼠
鼢	鼢
鼣	鼣
鼤	鼤
鼥	鼥
鼦	鼦
鼧	鼧
鼨	鼨
鼩	鼩
鼪	鼪
鼫	鼫
鼬	鼬
鼭	鼭
鼮	鼮
鼯	鼯
鼰	□
鼱	鼱
鼲	□
鼳	鼳
鼴	鼹
鼵	鼵
鼶	鼶
鼷	鼷
鼸	鼸
鼺	鼺
鼻	鼻
鼼	鼼
鼽	鼽
鼾	鼾
鼿	鼿
齀	齀
齁	齁
齂	齂
齃	齃
齄	齄
齅	齅
齆	齆
齇	齇
齈	□
齉	齉
齊	齐
齋	斋
齌	齌
齍	□
齎	□
齏	齑
齒	齿
齓	□
齔	龀
齕	龁
齖	□
齗	龂
齘	□
齙	龅
齚	□
齛	□
齜	龇
齝	□
齞	□
齟	龃
齠	龆
齡	龄
齢	龄
齣	出
齤	□
齥	□
齦	龈
齧	啮
齨	□
齩	□
齪	龊
齫	□
齬	龉
齭	□
齮	□
齯	□
齰	□
齱	□
齲	龋
齳	□
齴	□
齵	□
齶	□
齷	龌
齸	□
齹	□
齺	□
齻	□
齼	□
齽	□
齾	□
龍	龙
龎	厐
龏	□
龐	庞
龑	□
龒	□
龓	□
龔	龚
龕	龛
龖	□
龗	□
龘	□
龜	龟
龝	□
龞	鳖
龠	龠
龡	龡
龢	龢
龣	龣
龤	龤
龥	□
□	刾
□	鲃
□	鳚
□	鳤
□	鹮
㗎	㗎
䀹	□
䁪	□
	□
㘘	□
𡃶	□
𤓓	□
𩗴	□
𡃴	□
𠼮	□
𠺪	□
𠾍	□
䳍	□
閪	□
𨳒	□
𨳊	□
𨶙	□
𨳍	□
嚒	□
㨥	□
䈫	□
𢝵	□
𢞵	□
𢰸	□
𡁜	□
𡃁	□
𨋢	□
𧢝	□
𢺳	□
𧩙	䜥
𡄽	□
𧕴	□
𢺋	□
𡁯	□
𩓙	□
𡁻	□
㒓	□
䖙	䖙
䛿	□
𩶘	䲞
呣	呣
嚡	嚡
巭	巭
旂	旂
㓟	㓟
㕕	㕕
㕭	㕭
㕸	㕸
㖠	㖠
㗅	㗅
㗆	㗆
㞗	㞗
㤻	㤻
㦴	㦴
㧵	㧵
㨘	㨘
㨢	㨢
㩒	㩒
㩧	㩧
㩻	㩻
㱦	㱦
㹃	㹃
㿭	㿭
䁓	䁓
䂿	䂿
䇱	䇱
䉭	䉭
䉺	䉺
䍇	䍇
䐙	䐙
䞘	䞘
䟜	䟜
䟴	䟴
䤚	䤚
䨣	䨣
䨩	䨩
䪂	䪂
䫯	䫯
䭮	䭮
䭰	䭰
𠜱	𠜱
𠝹	𠝹
𠮨	𠮨
𠱸	𠱸
𠵼	𠵼
𠵿	𠵿
𠶧	𠶧
𠸎	𠸎
𠺝	𠺝
𠺫	𠺫
𠼱	𠼱
𠼻	𠼻
𠽤	𠽤
𠾴	𠾴
𠿭	𠿭
𡁶	𡁶
𡉼	𡉼
𢆡	𢆡
𢠃	𢠃
𢫨	𢫨
𢭃	𢭃
𢯎	𢯎
𢯎	𢯎
𢱑	𢱑
𢱕	𢱕
𢴈	𢴈
𢶤	𢶤
𣖕	𣖕
𣚺	𣚺
𣲷	𣲷
𤆣	𤆣
𤊓	𤊓
𤘅	𤘅
𤶸	𤶸
𤷈	𤷈
𥄫	𥄫
𥇣	𥇣
𥊙	𥊙
𥹉	𥹉
𦟌	𦟌
𦢓	𦢓
𦧲	𦧲
𨂾	𨂾
𨃩	𨃩
𨅝	𨅝
𨆪	𨆪
𨈓	𨈓
𩬎	𩬎
